conflagration - n.武装冲突，战争

conflate - vt.混合

conform - vt.使协调；vi.遵照，遵从

conjure - vt.请求，恳求；vt.在脑海中浮现，想起

consent - n.同意，赞同；vi.同意

consign - vt.转交，转移(给他人)

consternation - n.惊愕，恐慌，恐惧

contemplate - v.沉思，仔细思索

contempt - n.蔑视，鄙视

contend - vi.竞争，争夺；vt.声明，声称

contradict - vt.否认，反驳；与...相矛盾

contrived - adj.不自然的，刻意的

convene - vt.召开，召集

correlate - vt.使...相关联

counterpart - n.(地位、功能)对等的人或物

counterproductive - adj.反效果的，阻碍预期目标的

courteous - adj.礼貌的，谦恭有礼的

coy - adj.不愿与人交往的，内向的

credit - n.信任，信赖；n.表扬，赞扬

crow - vi.感到高兴

damn - vt.(在道德上)谴责

dampen - vt.抑制，压抑(感情、精力等)，泼冷水

dashing - adj.爱好冒险的，大胆的

dated - adj.过时的

deadlock - n.僵局；vt.使陷入僵局，使停顿

debonair - adj.无忧无虑的，不在乎的；adj.风度翩翩的

decadent - adj.堕落的，腐败的；n.道德上堕落的人

decry - vt.强烈反对，否定

deflect - vt.使偏斜，使转向

defray - vt.支付

deign - vi.(不情愿地)屈尊，俯就

delegate - n.代理人，代表；vt.移交(权力、任务等)

delineate - vt.描写，描绘

demote - vt.降职，降级

dependable - adj.可靠的，值得信赖的

deplorable - adj.可鄙的，可耻的

dichotomy - n.对立

dictate - vt.(仗着地位、权力)下令

discreet - adj.(言行)谨慎的

disenchant - vt.使清醒

dishearten - vt.使沮丧，使失去信心

disjunctive - adj.分离的

disprove - vt.反驳，证明为假

distinctive - adj.完全不同的；adj.特征性的，典型的

doctrinaire - adj.教条主义的，照本宣科的

domineer - vt.专制统治

drab - adj.单调的，无聊的

dramatic - adj.显著的，惹人注意的

dread - n.恐惧

duplicate - n.复制品；vt.复制

eclectic - adj.混合的，多元化的

efficacious - adj.有效的

elude - vt.躲闪，躲避；vt.使无法理解，使困惑

enamored - adj.迷恋的，热爱的

endeavor - n.努力，奋斗；vt.努力做，拼搏

enthrall - vt.(像用魔咒般)吸引

equilibrium - n.均势，平衡

escort - vt.同行，护送

ethos - n.道德准则

exorcise - vt.除去

explicate - vt.解释，说明

exterminate - vt.根除，消灭

extrapolate - vt.(通过逻辑)推断

fabulous - adj.幻想中的，不真实的；adj.极好的

fad - n.(短暂的)流行，时尚

fallible - adj.可能出错的

fanciful - adj.不切实际的，荒谬的

favoritism - n.偏爱，偏袒

featureless - adj.缺乏特征的

feisty - adj.好斗的，好争论的

felony - n.重罪

ferocious - adj.激烈的，爆发性的；adj.凶猛的，残暴的

fervent - adj.充满感情的，热情洋溢的

figment - n.虚构的事物，幻觉

fitful - adj.断断续续的

fleeting - adj.稍纵即逝的，短暂的

forage - vi.寻找

forebode - v.预示，预兆

foreground - vt.强调，重视

forfeit - n.罚金

forsake - vt.彻底放弃，抛弃

frosty - adj.寒冷的；adj.无强烈感情的，冷淡的

gawky - adj.(举止)笨拙的

germinate - vi.发芽；vi.出现

glacial - adj.极冷的；adj.冷漠的，无感情的

glide - v.轻松地行动，轻松地通过

glower - vi.怒目而视

graft - vt.移植，移接

grit - n.(面对困难时所表现出来的)毅力

groggy - adj.虚弱的，(走路)不稳的

grudge - n.怨恨，仇恨

grumble - vi.(尤指低声地)抱怨，埋怨

halfhearted - adj.不感兴趣的，不热情的

heckle - vt.起哄，使难堪

hierarchical - adj.分等级的，等级制的

hobble - vt.阻碍，妨碍

humdrum - adj.无聊的，乏味的

humiliate - vt.羞辱，使丧失尊严

hypothetical - n.假设，前提条件；adj.假定的

idiosyncrasy - n.独特而奇怪的习惯
