interminable - 无尽头的：no end

intermittent - 间歇的，断断续续的：not continuous；
不定期的：lacking regularity

interregnum - 过渡期：break

interrogate - (vt) 质问，审问：question formally

intimate - 有紧密联系的，亲密无间的：close association；
不为人知的：not known；
密友：person who has a strong liking；
(v) 迂回地交流，间接地沟通：communicate indirectly

intimidate - (vt) 威吓：frighten

intoxicant - 使人陶醉的东西（尤指酒精饮料）：intoxicates

intransigent - 不妥协的，固执的：refusal to compromise

intrepid - 无畏的：resolute fearlessness

intrigue - (n) 阴谋：a secret plan；
(vt) 激起...的兴趣：arouse curiosity

intrinsic - 固有的，内在的：essential

intuitive - 直觉的：by intuition

inundate - (vt) 淹没：cover with flood

inure - (vt) 使习惯接受不好的东西：accustom；
{(vt) 使坚强：withstand physical hardship}

invective - 侮辱性的：characterized by insult

inveigh - (vi) 激烈抗议，表示强烈不满：protest vehemently

inveigle - (vt) 诱骗：win over by coaxing

inventory - {(n) 存货清单：list all goods}
(n) （包含要点的）简介：short statement

inveterate - 根生蒂固的／积习的：firmly established

invidious - 惹人反感的：cause discontent；
羡慕嫉妒恨的：resentment of another's possessions

invigorate - (vt) 使精神，使强壮，鼓舞激励：impart vigor

invincible - 不可战胜的，不可超越的：incapable conquered

invoke - (vt) 实施：put into effect；
(vt) 产生，造成：be the cause

irascible - 易怒的：easily provoked anger

irate - 极其愤怒的：extremely angry

iridescent - 五颜六色的：lustrous colors

irk - {(n) 令人烦恼的事物：source of irritation}
(vt) 使烦恼，使厌倦：irritating

ironclad - 非常坚固的，坚不可摧的：unbreakable

irradicable - 不能根除的：impossible destroy

itinerant - 巡游的，巡回的：traveling from place to place

irrigate - (vt) 灌溉：supply water；
(vt) 冲洗：flush

irritate - (vt) 刺激，惹恼：provoke anger

issue - (n) （有争议的）话题，议题：matter that is in dispute；
(v) 发布（期刊）等：produce and release；
(v) （使）流出：flow out

jabber - (vi) 快而不清楚地说：talk rapidly, indistinctly

jaded - {疲惫的：depleted in strength}
厌倦的，没兴趣没热情的：patience exhausted

jape - (v) 嘲弄：mockingly

jargon - 行业术语：specialized or technical language

jarring - 刺耳的：discordant
{震惊的：strong emotional reaction}

jaundice - （因嫉妒或厌世而产生的）偏见：bias

jaunty - 轻快的，活泼的：sprightly

jejune - 无趣乏味的：not interesting
{幼稚的：annoying qualities children}

jettison - 放弃，拒绝接受（想法、计划等）get rid of

jeopardy - 危险： risk, danger

jest - (n) 轻浮的态度，戏谑：frivolous

jibe - (vi) 意见一致：agree

jingoist - 极端爱国激进分子（通常表现为好战的对外政策）：extreme nationalism belligerent

jitters - (n) 紧张，不安：panic, nervousness

jocular - 搞笑的，欢乐的：joking, playful

jocund - 欢快的，高兴的：sprightly lighthearted

jog - {(n) 慢跑：movement exercise}
(vt) 唤起：rouse

jolt - {(vi) 突然移动：move sudden}
(vt) 惊吓：unpleasant surprise

jot - (vt) 简要记录：write briefly

jovial - 愉快的：good-mannered, jollity, conviviality

jubilant - 喜悦的：joyful

judicious - 明智的，慎重的：judgment prudent

juggernaut - 无法阻挡的力量的，摧毁一切的强大力量：overwhelming force

ken - 视野范围：vision；
(vt) 知道，了解（人或物）：know

kidnap - (vt) 绑架勒索：detain unlawful force

kindle - (vt) 点燃：set fire, ignite

kindred - 类似的；具有相似或相近的起源、本性或性质的：similar origin

knack - 诀窍，聪明的做法：clever

kilter - 平衡: fitness(适合)

knit - (vt) 连接，联系：join closely

knotty - 复杂的，困难的：full of difficulties complications

kudos - (n) 名望，名声：fame；
(n) 夸奖，赞扬：acclaim or praise

labile - 易变的，不稳定的：unstable

laborious - 勤奋的：industrious；
费力的：long, hard work

labyrinthine - 迷宫似的，复杂曲折的：extremely complex structure

lacerate - (vt) 使非常痛苦：cause pain

lackluster - 黯淡无光泽的：lacking brightness

laconic - 简洁的（以至于显得粗鲁或难以理解的）：minimum of words, concise

lachrymose - 催人泪下的，悲伤的：mournful

lambaste - (vt) 严厉斥责：scold sharply

lament - (v) 为...哀悼，表达痛苦或遗憾：express sorrow
{(n) 悼词：composition grief；
(n) 抱怨：resentment}

libelous - 恶意中伤的，诽谤的：libel

lampoon - (n) 讽刺：harsh satire

languid - 没精打采的，虚弱的：lacking energy

languish - (vi) 变得衰弱：become feeble

languor - (n) 懒惰：inertness；
(n) 衰弱：weakness, weariness

lank - 细长瘦弱的：long lean；
不僵硬的，柔软松弛的：limp, not stiff

lapse - 小过失：slight error；
(vt) 结束，终止：end

largesse - 慷慨：liberality
{捐赠物：without expectation of a return}

lash - (n) 击打：hard strike；
(v) 猛击，撞击：strike with force；
(vt) 捆扎：bind

lassitude - (n) 乏力，没精打采：diminished energy

latent - 潜在的，不活跃的：potential, not evident

latitude - (n) （行动或言论）自由：freedom

laudatory - 表示赞扬的：praise

lavish - 奢侈的，大量的，无节制的：extravagance and profusion；
(vt) 挥霍，浪费：give readily carelessly

leaven - (vt) 在...中加入轻松、活泼或变更的因素：mingle permeate

leer - (vi) 一瞥，斜眼看：sidelong

leery - 怀疑的，不信任的：suspicious

legacy - 遗产：handed down ancestor

lucrative - 有利可图的 profitable

legion - 大量的：numerous
{大量的人，（尤指）军团：large body of men}

lenient - 宽大仁慈的：merciful

lethal - 非常有害的，致命的：extremely harmful

lethargic - 没精打采的，行动迟缓的：sluggish

levelheaded - 明智的：sensible

levity - (n) 轻浮：frivolity

liability - 责任：liable；
障碍，不利条件：creates difficulty
