idle - adj.闲置的，未使用的；adj.懒散的；v.懒散度日，无所事事

ill-bred - adj.没有教养的，没有礼貌的

illustrious - adj.著名的，杰出的

imperishable - adj.不朽的，永恒的

implicit - adj.不言而喻的，心照不宣的

impunity - n.免责，免受处罚

incentive - n.刺激，诱因

incumbent - adj.义不容辞的，必须的

indehus - adj.不合乎礼节的，不得体的

infraction - n.违背，违犯

justify - vt.证明...的合理性，为...辩解

lag - v.缓慢行走；v.萎靡，失去活力

lance - vt.刺穿，刺破

lax - adj.松弛的，不紧的，不严格的；adj.懈怠的，漫不经心的

license - n.许可，认可；n.自由

lionize - v.追捧，把...捧为名人

ludicrous - adj.荒唐的，可笑的

luminous - adj.杰出的，重要的

lurid - adj.恐怖的，令人反感的

machination - n.诡计

madcap - n.热爱冒险的人；adj.大胆的，鲁莽的

magnitude - n.重要，重大

malevolent - adj.恶意的，恶毒的

malignant - adj.恶毒的，邪恶的

maneuver - v.巧妙地操纵

marginal - adj.不重要的

meditate - vt.思索，沉思

menial - adj.卑贱的，低下的

meretricious - adj.艳俗的，俗气的

milieu - n.环境，氛围

misapprehension - n.错误的理解、判断

monarch - n.君主，帝王

monopolize - v.垄断，主宰

nirvana - n.天堂

nostalgia - n.怀旧，怀念

notoriety - n.坏名声

nourish - v.培养，促进

novice - n.新手，初学者

nullification - n.(尤指法律条文等正式的)废除，废弃

numb - adj.麻木的，无感情的

oaf - n.愚蠢的人

observant - adj.警惕的，警觉的；adj.严格遵守(规章、制度或原则)的

obsolete - adj.过时的，被淘汰的

onset - n.起始，开始

ordeal - n.严峻的考验

ostensible - adj.表面上的，佯装的

outgrowth - n.结果，后果

outmoded - adj.过时的，废弃的

override - v.推翻

overshadow - v.(在重要性上)超越，超过

overwhelm - v.淹没

overwrought - adj.十分激动的，非常不安的；adj.(装饰、文风等)过分华丽的

palaver - n.对话，交流；v.闲聊

palpitation - n.(有节奏的)舒张收缩

panacea - n.万能药，万灵药

peculiarity - n.特征，特点

pedagogical - adj.教学的；教师的

peel - v.脱去(衣服等)

perceptive - adj.敏锐的

perilous - adj.危险的

perquisite - n.额外的好处

petulant - adj.易怒的，爱发脾气的

pioneer - n.扩荒者，先驱者；v.开创，创造

pious - adj.(信仰上)虔诚的

pitfall - n.陷阱

pivotal - adj.最关键的，最为重要的

placid - adj.冷静的，淡定的

playful - adj.爱开玩笑的

plebeian - adj.平民的，社会下层的

plush - adj.奢华的，豪华的

poach - vt.水煮

pointer - n.忠告，建议

pragmatic - adj.实用主义的，务实的

premeditate - v.预先考虑

prerequisite - n.前提，先决条件

prerogative - n.特权，权力

proclaim - v.宣告，使...公之于众

project - v.预测，预计

proprietary - adj.私营的

prototype - n.原型

rampant - adj.(植物)生长茂盛的；adj.猖獗的，不受限制的

ravenous - adj.食量大的，贪食的；贪婪的

redeem - v.改过自新

refreshing - adj.令人身心振奋的，提神的

remnant - n.残余，剩余物

renege - v.放弃，摒弃

replenish - v.补充

replicate - v.复制，复刻

residual - adj.剩余的，残存的

restitution - n.补偿，赔偿

resurrect - v.使重生，使复苏

retentive - adj.记性好的

retrieve - v.寻回，找回

reverberate - v.回荡，回响

rhetorical - adj.言辞华丽(却往往无内涵)的

rigmarole - n.混乱无意义的话

ruthless - adj.没有怜悯心的，残忍的

screen - n.掩护物，屏障；v.掩护，遮蔽

scrimp - v.节俭

sectarianism - n.宗派主义，顽固
