veracious - 诚实的，说实话的：telling the truth
{精确的，准确的：precise}

verbatim - (adj, adv) 逐字地（的），一字不差地（的）：exact words

verbose - 冗长的，啰嗦的：more than necessary

verdant - （因长满植物而）翠绿的，郁郁葱葱的：green with vegetation

verify - (vt) 校验，证实：determine accuracy

verisimilar - 貌似真实的：having the appearance of truth : PROBABLE

vile - 丑陋的：unpleasant to look at
（道德上）可鄙的，卑鄙的：morally despicable

vernacular - 方言：nonstandard language；
非正式的，口头的：suitable for speech

versatile - 多才多艺的，全能的：different things；
{易改变的：fluctuating readily}

verse - (vt) 使精通，使熟悉：familiarize；
诗歌：rhythm lyrical effect

vertigo - 眩晕：dizzy

verve - 活力，热情：vitality

venue - 场地：area or space

vestige - 微小的痕迹；小痕迹：smallest trace

vocation - 职业：employed

veteran - 老兵；有丰富经验的人：knowledge through long experience；
经验丰富的，资深的：knowledge, experience

veto - (n, vt) 否决，禁止：forbid, prohibit

vex - (vt) 使烦恼，使恼怒：bring agitation

viable - 可行的：being done

vicarious - 代理的，取代的：substitute for another

vicious - 凶恶的，恶毒的：desire to inflict；
猛烈的：violence or ferocity

vicissitude - 自然变化，变迁兴衰：natural change

victimize - (vt) 使受骗：subject to deception

vigilant - 警醒的，警惕的：alertly watchful

vignette - 简介，短文：vivid representation

vigorous - 精力旺盛的：active strength；
强健的：withstand hardship

vilify - (vt) 诽谤，辱骂：utter slanderous statements

vim - 活力，精力：energy

vindicate - (vt) 为...平反，为...辩护，使无罪：free from blame；
(vt) 证明，证实：give evidence

vindictive - 复仇的，有寻仇倾向的：seek revenge

virtuoso - 艺术鉴赏家，专家：masterly skill；
经验丰富的，技艺精湛的：exceptional knowledge

virtuous - 品德高尚的，正直的：showing moral excellence

virulent - 有毒的：poisonous
{凶残的：destructive course}

viscid - 有粘性的：glutinous

viscous - 粘稠的，粘的：viscid

visionary - 空想的，不切实际的：guided by ideals；
幻觉的：in the imagination；
有远见的：foresight

vitality - 活力，生命力：vigor

vitiate - (vt) 削弱，损害：reduce the value
{(vt) （在道德、审美上）降低，堕落：debase in moral}

vitriolic - （言辞）刻薄的：scathing

vituperate - (vt) 谩骂，责骂：abuse or censure

vivacious - 活泼的，快活的：lively

vociferous - 喧哗的，大叫大嚷的：vehement outcry

volatile - 多变的：rapid change

volition - 意志，自愿选择的行为：making one's own choices

voluble - 健谈的，多话的：ready speech

voluminous - 卷数多的，大量的，庞大的：great number

voluptuous - 奢侈逸乐的，沉湎酒色的：enjoyments luxury

voracious - 有很大食量的，贪吃的：huge appetite；
贪婪的，如饥似渴的：insatiable

votary - 崇拜者，信徒：fervently devoted

vouch - (v) 担保，声称为真：give a guarantee

vulgar - 粗俗的，无教养的：crude；
口头的，非正式的：suitable for speech

vulnerable - 易受攻击的，脆弱的：open to attack

waddle - (vi) 摇摇摆摆地走:tilt the body from side to side

waffle - (vi) 胡扯：talk foolishly

waft - (v) 飘荡，漂浮：float

wag - (v) 摆动：move to and fro or up and down
{诙谐幽默的人：humorous}

wan - 苍白的，病态的：poor health

warble - v. 柔和地唱歌 sing with melodic embellishments

wane - (vt) 减少，衰退，降低：decrease

wanting - 未出现的，缺少的：not present；
未达到要求的：not being up to standards

warmonger - 好战者：urges war

warp - (vt) 曲解：alter the meaning
{(vt) 使偏向：turn；(vt) 扭曲 ，变形：twist}

warrant - (vt) 向...保证质量：assume responsibility for the satisfactory quality；
(vt) 批准，认可：give official acceptance

wary - 小心的，机警的，谨慎的：caution

wastrel - 肆意挥霍的人，败家子：expends self-indulgently

watershed - 重要关头，分水岭：turning point

wax - (vi) 增大，增强：increase
{(vi) 月亮渐满：increase in the phase of the moon；(vt) 用蜡涂、处理或上光：coat}

waylay - (vt) 埋伏，伏击：attack

welter - 混乱，动乱：disorder

wheedle - (v)（用花言巧语）诱惑，哄骗：persuade by flattery

whet - 刺激，激起：make more acute
{(vt) 磨快：sharpen}

winnow - 筛选：examine closely

whimsical - 反复无常的：sudden illogical changes

wholesome - 有益身心健康的：promoting health

wicked - 邪恶的：morally bad

wince - (vi) 畏缩：shrink back from pain

windbag - 健谈的人：talkative

windy - 冗长的：verbosity

winsome - 迷人的，漂亮的：pleasing and engaging

wit - 机智，智慧：ability to understand；
智者，有智慧的人：intelligence

withdraw - (v) 撤退：take back

wither - (vi) 枯萎，凋谢：become sapless

withhold - (vt) 抑制；扣压，不给予：refrain from giving

wizen - (v)（使）凋谢，（使）枯萎：become wrinkled；
(adj)凋谢的，枯萎的：dried up

wobble - (vi) 摇晃，颤抖：move or proceed unsteadily；
(vi) 犹豫不决：show uncertainty

worldly - 世间的，世俗的：rather than spiritual；
老练的：experienced

windfall - 好运，幸事：unexpected gain or advantage

wrangle - (n) 纷争，争端：differing opinions；
(vi) 争吵：quarrel

wretched - 极差的：poor in quality；
{沮丧的：dejected}

wry - 坚持错误的：stubborn to wrong
{扭曲的：twisted, bent}

xenophobe - 仇视（或畏惧）外国人（或外国事物）者：fearful of what is foreign

yoke - (v) 连接：become joined

yokel - 乡下人，天真纯朴的人：inhabitant of a rural area

zeal - (n) 热心，热诚：enthusiastic devotion

zealot - 狂热者，极端主义者：extreme, following political or religious belief

zenith - 最高点，巅峰：culminating

zesty - 刺激的，开胃的：piquant
