despicable - 令人鄙视的：loathing and disgust；
不荣耀的，不得体的：not honor

despise - 极其不喜欢的：dislike strongly

despotic - 专制的，暴虐的：tyrannical

desultory - 无计划的，无目的的：lacking plan；
令人失望的：disappointing

detach - (vt) 使分离：separate

detain - (vt) 拘留，扣留：hold, keep

deter - (vt) 吓住，威慑：prevent, discourage

deterioration - (n) 恶化，堕落：sinking

detour - (n) 偏离正常标准：away from standard；
(v) 改变方向或者路线，绕道：change direction

detract - (vt) 贬低，降低价值：diminish；
(vt) 使分心：draw attention

detritus - 废品，碎屑，遗骸：product disintegration, destruction, debris

devoted - 投入的，忠诚的：loyalty, devotion；
示爱的，恩爱的：love

devout - （对于宗教）虔诚的：devoted to religion；
忠诚的：allegiance

dexterous - 动作灵活的：ready, skilled；
头脑灵活的：mentally adroit, skillful

diabolic - 恶魔一般的：devil

diaphanous - 模糊的；非实在的：vague insubstantial；
（质地精致得）几乎透明的：transparent, translucent

diatribe - (n) 长篇抨击性演讲：long scolding；
(n) 挖苦，讽刺的指责：ironic, satirical

didactic - 喜欢说教的：teach

diehard - 顽固的，保守的／顽固的人，保守的人：determined, devoted/opposes change, refuses new ideas

dovish - adj. 鸽派的，爱好和平的

diffuse - 啰嗦的：verbose；
不集中的，扩散的：not concentrated；
(v) 扩展，散开：extend, scatter

digress - (v) 脱离主题：turn aside main subject

dilapidate - (v)（使）荒废：ruin

dilate - (v)（使）膨胀，扩大：enlarge, expand, wide；
(v) 详细表达：more fully greater detail

dilatory - 拖延的，磨蹭的：cause delay procrastination

dilettante - (n, adj) 业余爱好者（对艺术或知识领域涉猎浅薄者）／缺乏专业技术的：superficial interest/lacking expert skill

diligent - 勤勉的，辛勤的：steady, earnest, energetic

dilute - (vt) 稀释／经稀释的：concentrated/low strength, concentration；
(vt) 削弱：diminish strength, flavor, brilliance

diminish - (v)（使）变小，（使）减少：smaller, less；
(v) 轻视，贬低：lessen, belittle

disquisition - n. 专题论文

dingy - 昏暗的；肮脏的：darkened, dirty

diocesan - 主教管辖区的：diocese

diplomatic - 使用策略的，机智的：tact

dire - 可怕的，恐怖的：fear；
迫切的：immediate, urgent；

demography - 人口统计学

disabuse - (vt) 打消错误念头，纠正：free from error, fallacy, misconception

disaffected - 不满的，叛逆的：discontented

disarm - (v) 解除武装：reduce armed forces；
(vt) 使息怒，平息，抚慰：lessen；

disarray - (n) 混乱，无秩序：lack order；
(vt) 使混乱：undo order, arrangement

disavow - (vt) 拒绝承认，否认：disclaim

discern - (v) 识别，辨别差异：perceive, detect

discharge - (vt) 解雇：dismiss；
(vt) 释放：free；
(n) 不承担责任：freeing obligation, responsibility

disciple - 信徒，追随者：follower

discombobulate - (vt) 使不安，使混乱：upset, confuse

discomfit - (vt) 使尴尬：embarrassment；
(vt) 阻碍：prevent

discommode - (vt) 打扰，使不便：trouble

discompose - (vt) 使不安：disturb composure, perturb；
(vt) 使混乱：undo order, arrangement

disconcert - (vt) 使不安：disturb

discord - (n) 意见不一致，不和谐：lack agreement, harmony

discredit - (vt) 羞耻，使丧失名誉：damage reputation, disgrace；
(vt) 怀疑，不相信：not true, real

discrepancy - （在事实和宣称之间的）差异或矛盾：divergence, disagreement

discrete - 离散的，不连续的：separate

discretion - (n) 谨慎：discreet, circumspection；
(n) 自制，节制：checking

discretionary - 自主决定的：one's own discretion

discriminate - (vt) 区分：perceive distinguishing, recognize；
(vi) 歧视：difference

discursive - （谈话内容）杂乱的：without order

disdain - (vt) 轻视，鄙视：scorn

disengage - (vt) 分开，使脱离：set free, entanglement

disgorge - (v) 呕吐出：discharge, vomit；
(v) 被迫放弃：give up

disgruntle - (vt) 使发怒，使不满意：discontented；
(vt) 使疏远，使不友好unfriendly

dignified - adj. 高贵庄严的

disinclination - (n) 不喜欢，厌恶，不情愿：lack willingness, desire

disinfect - (vt) 消毒，使无菌：free from infection

disjointed - 机能失调的：out orderly function；
不连贯的：not connected

disinter - (vt)（从墓地里）掘出：take out

disinterested - 公正的，无偏见的：free from selfish, unbiased；
没有兴趣的：lack interest, concern

disjunctive - 分离的：breaks disunity

dismantle - (vt) 分解，分拆：pieces, destroy integrity

dismay - (vt) 使失去勇气：lose courage；
(vt) 使不安，使焦虑：trouble, uneasy

disparage - (vt) 贬低；轻蔑：lower, disrespectful

disparate - 迥然不同的：distinct, different dissimilar

dispassionate - 客观公正的，不易被情绪或偏见影响的：unaffected

dispatch - (n) 迅速：promptness；
(vt) 发送，派遣：one place to another；

dispose - (vt) 使倾向于：tendency incline；
(vi) 处理掉（与of连用，dispose of）：get rid of, throw out；

disregard - (vt) 漠视，不关注：no attention；
(n) 缺乏兴趣，缺乏关心：interest concern

dissect - (vt) 仔细分析：examine, analyze minute；

dissemble - (v) 用假象隐藏真相，掩饰：false

disseminate - (vt) 散播，传播：spread, promulgate

dissension - 意见不合：difference, disagreement

dissent - (vi) 持异议，不同意：differ；
(n) 反对正统：departure accepted；

dissipate - (vt) 驱散：drive away, disperse；
(vt) 浪费：wastefully, squander

dissolute - 放荡的，无节制的：restraint, indulging

dissolve - (v) 溶解融化：solution；
(v) 解散：break into parts, disintegrate；
(v) 驱散；（使）消失：cease visible；
(v) 废除，撤销：end

dissonance - (n)（音调）不和谐，刺声；不一致，分歧：disagreeable

dissuade - (vt) 劝阻，反对：deter persuasion, exhortation

distain - (vt) 贬损，伤害（某人的）名誉：lose honor, respect, reputation；
(vt) 弄脏：dirty

distal - 远离中心的，（神经）末梢的：situated away

distend - (v) （使）膨胀：expand

distill - (vt) 对...用蒸馏法提高纯度：increase, purify；
(v) （使）渗出；（使）滴下：fall drops

distort - (vt) 扭曲，歪曲：twist

distract - (vt) 转移（注意力），使分心：draw, direct different；
(vt) 使焦虑，使不安：trouble, uneasy；
疯狂的：insane, mad

distraught - 精神狂乱的，极疯狂的：agitated, insane

diurnal - 白天发生或行动的：daytime

diverge - (vt) （使）分叉，散开：different directions central；
(vi) 存在分歧：different, differ；
(vi) 背离，离题：depart from

diversity - 多样性：variety, multiformity；
分歧，不同点：different

divert - (vt) 使转向：turn, deflect；
(vt) 使消遣：agreeably；
(vt) 使分心：draw something else

divestiture - (n) 剥夺：taking away

divulge - (vt) 泄露（秘密）：known confidence, secret

dodder - (vi) 蹒跚，颤巍巍地行进：progress unsteadily

dodge - (v) 躲避：avoid
