falsehood - 谎言：untrue, made in order to deceive

falter - (vi) 蹒跚：walk unsteadily；
(vi) 犹豫踌躇：unsteady in purpose or action

fanatic - 狂热者：unreasoning enthusiasm；
狂热的；盲信的：intense uncritical devotion

fantasy - 幻想：imaginative fiction；
(vt) 产生幻想：form a mental picture

farce - 闹剧：ridiculous

fascinate - (vt) 强烈吸引，使入迷：hold an intense interest

fast - (n) 绝食，斋戒：abstaining from food；
忠诚的：firm in one's allegiance

fastidious - 挑剔的，极仔细的，追求完美的：meticulous attention to detail

fateful - 意义重大的：momentous；
带来灾难的，毁灭性的：bringing death

fathom - 测量（深度）：measure the depth；
彻底理解，弄懂：come to understand

fatigue - 疲惫：weariness or exhaustion；
（让人厌倦的）苦差事：causes weariness

fatuous - 愚笨的，昏庸的：foolish

faultfinder - 吹毛求疵的人：petty criticism

favorable - 有利的：promote

fawn - (vi) 阿谀奉承：seek favor by flattery

faze - (vt) 打扰，使尴尬：disturb the composure

feckless - 无成果的，没有价值的：having no worth；
粗心不负责任的：careless

fecund - 多产，肥沃的：fruitful

feeble - 衰弱的：lacking in strength

feign - (vt) 制造假象，装出...的样子：give a false appearance

foreshadow - v. 预示 beforehand, prefigure

feral - 野生的：not domesticated

fertilize - (vt) 使肥沃，使多产：make fertile

fervid - 酷热的：high temperature；
热情的：great passion

forte - (n)优势，长处：special talent

fester - (v) 感染，溃烂，腐烂：corrupt

fetid - 恶臭的：offensive smell

fetter - (vt) 束缚：restrain from motion

fiasco - 大失败：complete failure

fickle - 易变的：likely to change；
{不忠诚的：not true in one's allegiance}

fictitious - 虚构的：not real

fidelity - 忠诚：being faithful

figurative - 比喻的：denoting another

fractious - 难以管束的 ：unruly

filibuster - (vt) 拖延议事：for the purpose of delaying legislative action

filter - (v) 过滤：pass through a filter；
(v) 去除杂质：remove impurities

finale - 终场，结局：closing part

finesse - (n) 娴熟技巧：skill；
(v) （巧妙地）躲避：keep away from

finicky - 过分讲究的，挑剔的：extremely meticulous

flaccid - 不结实的，松弛的：lacking firmness

flag - (vi) 变得衰弱：become feeble

flamboyant - 艳丽夺目的，炫耀的，充满装饰的：strikingly elaborate

flatter - (vt) 拍马屁，奉承，讨好：praise excessively；

flaw - (n) 瑕疵，缺点：imperfection；
(v) 降低，破坏，使不完美：reduce perfection

fledgling - 新手：starting out in a field

fleet - 迅速的：with great speed；

flexible - 灵活的，可变的：readily changed；
易受影响的：susceptible to influence

flinch - (vi) 畏缩；退缩：draw back

flippancy - 轻率，无礼：unbecoming levity

flirt - (vi) 调情：behave amorously；
(vi) 无规则地快速运动：make irregular movements

flit - (vi) 快速或突然地经过：pass quickly

flock - 人群，兽群：creatures massed together；
(vi) 聚集，集体行动：travel in a flock

florid - 辞藻华丽的，花哨的：fancy expressions；
装饰华丽的：elaborately decorated

flounder - (vi) 笨拙地行动，挣扎：act clumsily

flourish - (vi) 茂盛，繁荣：achieve success；
(n) 装饰：ornamentation

flout - (v, n) 嘲弄性不理会，蔑视：treat with disregard

flabby - adj.疲软的，无力的

fluent - 表达流利的：able to express well；
不费力的：minimal difficulty

fluky - 侥幸的：happening by good luck

flush - （肤色）健康红润的：healthy reddish；
富有的：money in abundance；
大量的：abundance；冲洗：pour liquid

fluster - (vt) 使慌乱：put into agitated confusion

foible - 小缺点：minor flaw

foil - (vt) 挫败：prevent from being successful

foment - (vt) 助长，煽动：promote the growth

foolproof - 十分简单以至于不会失败的：leave no opportunity for error, misuse or failure

footloose - 无拘无束的，自由的：having no attachments

forbearance - (n) 克制，忍耐：tolerance and restraint；
(n) 友好仁慈的态度：kind, gentle or compassionate treatment

forebear - 祖先：an ancestor

forestall - (vt) 预先阻止：prevent beforehand

foreword - 前言：preface

forge - (v) 伪造：imitate falsely；
(v) 铸造，铸就：form；

formidable - 令人害怕的：causing fear；
艰难的：requiring effort

forthright - 直率的，说话率真的：free in expressing opinions；
直接的，不绕弯子的：free from ambiguity or evasiveness：going straight to the point

fortify - (vt) 加固，鼓励：give physical strength

foster - (vt) 促进，鼓励，培养：help the growth；
(vt) 养育：bring to maturity

founder - 建立者：one establishes；
(vi) 完败：fail utterly；
(vi) 沉没：become submerged

fracas - 争吵，吵闹：physical dispute, noisy fight

fracture - (n) 破裂：breaking；
(vt) 打碎，破坏：separate into pieces

fragile - 易碎的：broken；
易受伤的，脆弱的：easily injured

frail - 虚弱的：weak；
（意志）薄弱的：weak；
（希望）渺茫的：slight

fraudulent - 欺诈的：fraud

fraught - 充满的：full；

frenzy - (n) 疯狂，狂怒：mental agitation

far-fetched - adj.牵强的，不可信的 not likely to be true

fretful - 易怒的，烦躁的：vexed

friable - 易碎的：easily crumbled

friction - (n) 摩擦：rubbing；
(n) 冲突，不和：clashing；

frigid - 严寒的：cold；
冷漠的：lacking warmth

fringe - 边缘：border；
(vt) 与...接壤，位于...的边缘：be adjacent

frivolous - 轻浮的：unbecoming levity；
不重要的：little importance

frothy - （内容等）快乐轻佻、不严肃的：gaily frivolous

frowsy - 邋遢的：slovenly

frugal - 节约的：economy

fungible - adj.可互换的 substituted in place of one another

full-bodied - 重要的：importance；
味道浓烈的：richness flavor

fulminate - (v) 大声斥责：thunderous denunciation

fumble - (v) 笨拙地做：awkward attempts；
(n)（无意识的）失误：departure from truth

furor - (n) 喧闹，狂怒，激动，狂热：intense excitement

furtive - 鬼鬼祟祟的；秘密的：stealth

fury - (n) 暴怒：rage
