referee - 仲裁者；裁判员：impartially resolves a dispute；
(vt) （就纠纷或争论）给出意见：give an opinion

refine - (vt) 改善，改进：improve or perfect
{(vt) 提纯，精炼：free from impurities}

reflect - (vt) 反射：change direction；
(vt) 反映，显露：make manifest；
(vi) 思考：think seriously

refractory - 倔强的，不顺从的：resisting control

refulgent - 辉煌的，灿烂的：shinning radiantly

refute - (vt) 否认：declare not to be true；
{(vt) 证明为假，证伪：prove wrong}

regenerate - (vt) 使重获新生，使焕然一新：bring back to life；
{(v)（使）洗心革面：better in character}

regimen - （政治上的）统治：lawful control

regress - (vi) 后退：back；
(vi, n) 退化，恶化：worse

rehabilitate - (vt) 使复原，使康复：restore to healthy condition；
{(v) （使）洗心革面：better in character}

rehearsal - (n) 排练，彩排：practicing in preparation

reign - 统治权：right to command；
(vi) 占统治地位或盛行：be predominant

rein - (n) 抑制，限制：keeping within certain boundaries；
(vi) 抑制，控制：keep from exceeding

reiterate - (v) 重申：state again

rejoice - (vi) 欣喜，喜悦：feel joy

relapse - (vi) 重蹈覆辙，再犯：fall back

rehash - 重复，老调重弹：no abatement of severity

relentless - 残酷的，无情的：no abatement or severity；
固执的，不肯妥协的：yielding in one's purpose

relevant - 有关系的，重要的：having connection

reminiscent - adj.怀旧的，引发回忆的 provoking a memory

relinquish - (vt) 放弃（职位，权力等）：give up；
{(vt) 移交，交出：give control or possession}

relish - 喜好，偏好：appreciation or liking
(vt) 享受，喜欢：take pleasure
{（愿望达成时的）高兴，满足感：when wishes are met}

reluctant - 不情愿的，不要嘛：showing unwillingness

remiss - 疏忽的，不留心的：carelessness

resent - 怨恨 憎恨 angry or upset

remonstrance - (n) 抗议，抱怨：expression of protect, complaint

remorse - (n) 懊悔，悔恨：bitter regret

remunerate - (vt) 支付报酬，补偿：pay

rend - (vt) 撕裂，猛拉：tear or split apart

renegade - 背教者，叛徒：rejects allegiance

renounce - (vt)（正式地）放弃：give up；
(vt) 宣布与...决裂：refuse to follow

renovate - (vt) 修复，维修：restore；
(vt) 使重获新生，使焕然一新：bring back to life

repartee - 打趣，善意的玩笑：good-natured teasing

repatriate - (vt) 遣返：return to country

repeal - (vt) 撤销，废除（法律等）：rescind or annul；
{(vt) 宣布与...决裂：refuse to recognize}

repel - (vt) 使厌恶：cause aversion
{(vt) 抵制：fight against}

repertoire - （技术、设备或原料等的）详单：complete list

repine - (vi) 抱怨、表达不满：express discontent；
(vi) 渴望：long for

replete - 充满...的，富于...的：possessing great numbers

repose - （劳作后的）休息：state of resting；
平静，宁静：freedom from storm；

reprehend - (vt) 谴责，责难，批评：express unfavorable opinion

repress - (vt) 镇压：put down by force；
(vt) 阻止（正常的表达、活动或发展等）：prevent expression

reprieve - (vt) 对...暂缓处刑，免罪：postpone or cancel punishment；
{(vt) 维持...的运行：prevent from being closed}

reproach - (vt) 批评，责备：express criticism
{令人羞愧的事物，耻辱：causes shame}

reprobate - 堕落者，道德败坏的人：unprincipled person；
{堕落的，放荡的：morally corrupt；
(vt) 谴责，痛斥：condemn strongly；
(vt) 拒绝，不提供：unwilling to grant}

reproof - (n) 批评，反对：criticism

reprove - (vt) 温和地责备，警告：scold gently；
{(vt) 不欣赏，不喜欢：unfavorable opinion}

repudiate - (vt) 否认：declare not to be true；
(vt) 拒绝接受：unwillingness to accept

repugnant - 令人厌恶的：arousing aversion；
{不和谐的，不协调的：not harmony}

repulse - (vt) 使厌恶，排斥：reject with denial

repute - （尤指好的）名声，名誉：good reputation

requite - (vt) 酬谢，报答：make repayment；
(vt) 报仇：punish in kind

requisite - 必需品：something necessary；
必不可少的，必备的：necessary

rescind - (vt) 废除，取消：make void

reserved - 内向的，缄默的：restrained

residue - 剩余物：remains

resign - (vt) 辞职，放弃（职位）：give up office

resilience - 恢复能力：ability to recover quickly

resolute - 坚定的：firm determination

resonant - （声音）洪亮的，共鸣的：strong in tone

resourceful - 有创造力的，机智的：act imaginatively

respite - (vt, n) 间歇，休息：rest

retroactive - adj.有追溯效力的 extending in effect to a prior time

resplendent - 华丽辉煌的：brilliantly

responsive - 反应的，敏感的：quick to respond

restive - 急躁的，忧虑的：impatience, uneasiness；
{难以管束的：resisting control}

restless - 不平静的：lack of quite

revelation - 爆料，揭示：making known

resurgence - 复兴：restoration

resuscitate - (vt) 使复活，使苏醒：restore consciousness

retainer - 家仆：service

retaliate - (v) 报复，反击：pay back

retard - (vt, n) 减速，延迟：cause slowly

repetitious - adj.重复的，反复的 repeated many times

reticent - 沉默不语的：inclined to be silent；不愿意的：slow to begin

retort - (v, n) （尤指机智的）回应，回答：quick, witty reply

retouch - (v) 润饰，改进：improve

retract - (vt) 收回，否认：take back

retrench - (vi) 削减开支：curtail expenses

retribution - (n) 报酬，报应：reward or punishment

retrograde - 倒退的：moving backward；
(vi) 退步，退化：decline

retrospective - 回顾的：looking back

revel - 享乐，陶醉：take intense pleasure

revelry - 狂乐，喧闹的作乐：noisy partying

revenge - (n) 报复，复仇：retaliating；
(vt) 为...复仇：retaliating in kind

revere - (vt)（尤指对神的）尊崇，尊敬：respect

resonate - 有重要性：beneficial to the health

revive - (vi) 恢复意识：return to consciousness；
(vi) 再获新生：active again

revoke - (vt) 撤回，宣告无效：annul

revolt - (vt) 使厌恶，使反感：fill with disgust；
{(vi) 反叛：renounce allegiance}

ribald - （举止、言语）下流粗鄙的：vulgar

rickety - 不稳的：lacking stability

restorative - adj.有益健康的 beneficial to the health

ridicule - (vt) 嘲笑：make fun

rife - 丰富的，普遍的：great numbers

rift - (n) 分裂，不和：break friendly；
(vt) 使开裂：break

rile - (vt) 刺激，惹怒：make agitated

ripen - (v) 使成熟，变成熟：make ripe

riot - 喧闹，暴乱：public violence

rite - 惯例，仪式：prescribed form

rive - 撕开：tear apart
