fussy - 谨慎的：involving great care；
挑剔的：hard to please

fusty - 过时的：old-fashioned；
腐臭的：stale odors

futile - 无效的，无用的：ineffective；
{不严肃的：lacking in seriousness}

gadfly - 刺激物：provocative stimulus；
{令人反感的人：annoys}

gaffe - (n) （社交上）失礼，失态：social blunder

gainsay - (vt) 否认：declare false；
{(vt) 反对：oppose}

gall - (vt)（使）焦躁，激怒：irritate；
{大胆，无耻：boldness}

gallant - 英勇的：brave, chivalrous；
高贵的，慷慨的：dignified and generous

galvanize - (vt)（好似用电击）刺激：stimulate excite

gamble - (v) 赌博，孤注一掷：bet；
(vi) （使）受到威胁，冒险：in danger

gambol - (vi) 欢跳，雀跃：playfully

gag - n.笑话；玩笑之举 a joke

garble - (vt) 曲解，篡改，混淆（以至使无法理解）：distort misleading；
(vt) 筛选，除杂：remove

gargantuan - 巨大的：tremendous；

garish - 过于鲜艳的，过于张扬的：strident color

generic - adj.无差别的，普遍的 no particularly distinctive quality

garrulous - 啰嗦的，话多得令人厌烦的：tiresomely, talkative

guardian - 保护者，捍卫者

gleam - 闪光: light

gauche - 笨拙的，缺乏社交经验的：lacking grace

gaudy - 俗丽的：excessively showy

gauge - 测量标准：measurement standard；
(vt) 判定：determine

gear - (v) 调整（以配合）：adjust

genial - 和蔼亲切的：easygoing；
友好的，热心的：kindly feeling

genteel - 有教养的，不粗俗的：free from vulgarity

germane - 有关的，适当的：relevant

gibe - (v) 嘲弄：taunting words

giddy - 轻率不严肃的：lacking in seriousness；
喜悦的：elated

gild - (vt)（带欺骗性地）修改，润色：deceptively attractive

gist - 要点：main point

gigantic - 巨大的

glaze - (vt) 给...上釉，妆点：coat glaze；
(vt) 使平滑：glossy surface

glib - 流利圆滑的（常含有不真诚或欺诈的成分），油腔滑调的：fluency insincere deceitful；
缺乏深度的，肤浅的：lacking depth

glisten - (vi) 闪光：shine sparkling

glitch - 小故障：minor malfunction

gloat - (vi) 幸灾乐祸，自鸣得意：self-satisfaction

gloomy - 忧郁的：low spirits

gloss - (n) 简短解释：brief explanation, obscure；
(v) 敷衍潦草做事（甚至忽略）：too lightly

glossy - 平滑的，有光泽的：smooth surface

glut - (vt) 使过量，使充满：beyond capacity

glutinous - 胶状的粘的：glue

glutton - 贪吃者：immoderate food

goad - (vt) 刺激，驱使，激发：incite rouse

gobble - (vt) 狼吞虎咽：eat greedily

goggle - (vi) 凝视：look

goldbrick - (v) 逃避工作和责任：shirk responsibilities

gorge - 峡谷：canyon；
(v) 狼吞虎咽：eat greedily

gossamer - 虚无缥缈的东西：insubstantial；
轻薄的，薄弱的：light

grimy - 肮脏的 not clean

gourmet - 美食家：connoisseur food

grandeur - 宏伟，壮丽：grand

grandiloquent - （语言等）浮夸的：extravagantly, bombastic

grandiose - 自命不凡的，浮夸的：grandeur；
{宏大的：greatness}

grandstand - (vi) 为了给人留下印象而表演，哗众取宠：impress

grate - (v) 刮擦（以发出刺耳的声音）：rasping；
(v) 骚扰，惹恼：irritate

gratify - (vt) 使满足：desired please

gratuitous - 无根据的，无理由的：unwarranted；
无报酬的，免费的：without return；

green - 无经验的：deficient experience

gregarious - 爱社交的：enjoy the company；
群居的：group with others

grieve - (vt)（使）感到悲伤：deep sadness

glamorous - adj.迷人的 magical power to attract

grin - (v) 咧嘴笑，咧嘴笑着表示：express an emotion

gripe - (vi) 抱怨：dissatisfaction；
{(vt)（通过连续让人讨厌的举动）激怒，惹怒：disturb}

grisly - 令人反感的，令人恐惧的：repugnance

groove - (v) 享受，极其满意，过得快活：take pleasure in

grotesque - 难看的：unpleasant

grovel - (vi) 卑躬屈膝：draw back, fearful submission

grueling - 费时间花心思的：requiring

guile - (n) 狡猾，狡诈：misleading

glean - 收集：collect

gull - (vt) 欺骗：untrue

groundless - 没有依据的：no basis in reason

gush - (v) （使）大量涌出：great volume；
(v) （使）情感强烈外溢：exaggerated display

gust - (n) 情感爆发：sudden intense expression

guzzle - (v) 狂饮：drink greedily

hack - 雇佣文人：writer commercial；
(v) 乱砍；开辟：irregular blows；

hackneyed - 陈腐的，缺乏创新的：lacking freshness originality

halcyon - 宁静的，平静的：free from；
繁荣的，丰富的：affluent

hale - 强壮的，健壮的：free from infirmity or illness；
(vt) 拖，拉：cause to follow

half-baked - 不明智的：lack of good sense or judgment

hallmark - 典型的特征：conspicuous feature

hallow - (vt) 尊敬，把...视为神圣：respect

hallucination - (n) 错觉：false idea

ham-handed - 笨手笨脚的：lacking dexterity

hammer - (v) 屡次重申：repeated

hamper - (vt) 阻碍：restrict the movement, impede

hamstring - (vt) 使无效，使无力：ineffective

hangdog - 伤心的，沮丧的：sad, dejected

hanker - (v, n) 向往，渴望：desire, yearn

haphazard - 无秩序的，无目标的：lack of plan, order or direction

harangue - (v, n) （发表）长篇大论：long pompous

harass - (vt) 烦扰：irritate persistently；
{(vt) 耗尽...的体力：use up}

harbinger - 预言者：presages

harbor - (vt) 心怀，牢记：keep in one's mind

hard-bitten - 顽强的，经受得住困境、压力的：able to withstand

hardy - 顽强的：able to withstand；
愿意冒风险的：willing to take risks

harmonious - 和谐一致的：agreeably related

harness - (vt) 利用：utilize

harrow - (vt) 折磨，使苦恼：distress torment

harry - (vt) 不断烦扰，骚扰：distress, harass
