riveting - 吸引人的，极迷人的：absorbing engrossing

renaissance - 复兴 become popular again

robust - 精力充沛的，强壮的，健康的：full of strength

roil - vt. 激怒：displease
{vt. 搅浑，使混乱：stir up；}

rosy - adj.乐观的 inspire hope

rookie - 新兵；新生；菜鸟：recruit

rote - 死记硬背：using routine or repetition

rationale - n.基本原理，解释 explain

rouse - vt 激起，煽动：stir up；
vt 唤醒：stop sleeping

royalty - 皇家身份：regal character；
{版税；专利权税：payment}

rubicund - 红润的，健康的：healthy rosiness

rudimentary - 初始的，未发展的：earliest development；
最根本的，基础的：first principles

rue - n. 后悔，遗憾：feeling of regret

ruffle - vt. 使粗糙：destroy smoothness；
vt. 扰乱，打扰：disturb
{n. 皱褶，褶裥花边：strip edge}

ruminate - v. 沉思：go over in the mind

rumple - vt. 打乱，使不整齐：undo the proper order
{vt. 使皱，弄皱：form creases}

revision - 修订 emendation

runic - 神秘的：mysterious

rupture - v. 打破；打碎，破裂：part

ruse - 诡计：subterfuge

rustic - n. 乡下人，头脑简单的人：awkward or simple person；adj. 乡村的：open areas with few buildings
adj. 粗俗的：lacking polish

rustle - vi. 快速地行动：move or act with speed

sabotage - n. 妨害，破坏：hinder a cause；
vt. 从事破坏活动，阻止：practice sabotage

saccharine - 像糖一样的，有甜味的：sugar；
做作的，矫情的：appealing to the emotions

sacrilege - n. 亵渎圣物：profanation sacred

saddle - vt. 使某人担负：load

safeguard - n. 保护措施：prevent accident；
{vt. 保护：make safe}

sage - 智者：wisdom

salient - 显著的，最突出的：conspicuously

salubrious - 有益健康的：promoting health

salutary - 有益健康的：promoting health；
有利的，利好的：promoting well-being

salutation - n. 赞扬：praise
{n. 致敬，打招呼（表示欢迎和礼貌）：greeting}

salvage - vt. （从灾难中）抢救：save from loss

salve - v. 减轻：缓解：assuage

sanctify - vt. 使神圣，将...敬为神：make holy

sanctimonious - 假装虔诚的：hypocritically pious

sanction - vt. 批准，同意，许可：make valid；
n. 制裁：coercive measure

sanctuary - 避难所：protection

showcase - vt.展示（优点） exhibit in an attractive aseptic

sanguine - 乐观的，确信的：free from doubt；
{面色红润的：healthy reddish}

sanitary - 健康的，清洁的：health

sap - vt. 削弱：weaken energy vitality；
n. 健康，活力：active strength

sapient - 聪明的，有洞察力的：deep understanding, intelligent

sarcasm - n. 讽刺，轻蔑：ironic

sartorial - 裁缝匠的，裁缝的：clothes

sate - vt. 使饱足，充分满足：satisfy fully

satiate - vt./adj.（使）饱足（的），过分满足（的）：satisfy fully

scandalous - 引起反感的，丢脸的：disgust

satirize - vt. 讽刺：ridicule

saturate - vt./adj. 使饱和，浸透：wet thoroughly

saturnine - 忧郁的，阴沉的：lacking in cheer；
{讽刺的：sardonic}

saunter - vi. 闲逛，漫步：by foot

savant - 博学之士，学者：learning

savory - 令人愉悦的，pleasure or contentment
{口感好的，味道好的：appetizing taste, smell}

savvy - n. 老练，机智：knowledge actually doing；
{v. 明确了解：clear idea of；
adj. 有见识的，精明能干的：practical cleverness or judgment}

scads - 许多，大量：large number

scant - 不足的，缺乏的：scarcely

scathing - 尖酸刻薄的：cause hurt feelings

schism - n. 不一致：lack of agreement

scintillate - vi. 闪耀：sparks

seditious - 煽动性的，意在制造混乱的：excite political disorder

scission - n. 切断，分离，分裂：division

scoff - v. 嘲笑：derision, mock；
v. 狼吞虎咽：eat greedily

scorch - v. 炙烤，烘干：burn, make dry

scorn - vt. 轻蔑，鄙视，不屑：reject contemptible

scotch - vt. 停止：put an end to

scour - vt. 搜查：to find or discover
{vt. 用力擦洗：wash vigorously}

scowl - vi. 皱眉（表现出不高兴）：expression displeasure

scrappy - 好斗的，好吵架的：aggressive

scrap - vt. 抛弃：get rid of；
{vt. 终止，放弃原计划：put an end to
n. 废料，废物：discarded or useless}

scrawl - vt. 乱涂，潦草地写：write carelessly

scribble - v. 潦草地书写，乱写：meaningless

scrupulous - 正直的：principled；
一丝不苟的：great care and effort

scrutable - 可以理解的：understood comprehensible

scrutinize - vt. 仔细检查：observe great care

scuff - v.（使）磨损：roughened by wear

scurrilous - 说粗话的：vulgar

scurvy - 下流的，让人鄙视的：contemptible

seamy - 肮脏的，堕落的：sordid, base

secluded - 僻静的，隐蔽的：hidden

secrete - vt. 隐藏：conceal；
vt. 分泌：generate

sedate - 淡定的，安静的：free from agitation

sedentary - 固定不动的：not migratory

seduce - vt. 劝说（使不忠，使不服从），诱...误入歧途：persuade

sedulous - 勤奋认真的：careful perseverance

seemly - 得体的，遵守礼节的：following the established traditions

segment - vt./n. 分割；部分：separate

self-abasement - 自卑，自谦：humiliation

self-absorbed - 自恋的，自私的：absorbed in one's own

seminal - 创新的：creative
{有发展性的：contributing later development}

sensation - {感觉，知觉：sense}
轰动事件：intense interest

sift - 审查 examine

showmanship - n.擅长表演、展示的技巧 dramatically effective presentation

sepulchral - 阴沉的，丧葬的：lacking in cheer

septic - 腐败的，感染的：putrefaction

sequela - 结果：secondary result

sequester - vt. 使隔离，分离：segregate；
{vt. 使隐退：seclusion}

sere - 干枯的，凋萎的：dried, withered

serendipity - 意外发现珍奇（或称心）事物的本领：by accident

serene - 安静的：free from uproar；
{稳重的，镇静的：unaffected, calm}
