patrician - 贵族，名门望族：high birth；
贵族的，地位高的：high birth

patriot - 爱国者：loves country

patronize - (vt) 赞助：provide aid；
(vt) 以高人一等的态度对待：treat haughtily

paucity - 少量，缺乏：dearth

province - 职能范围内：field of activity or authority

peck - 大量：considerable amount；
(v)（不情愿地）小口咬：in small bites

pedagogue - 教育者，老师：give formal instruction

pedant - 书呆子，墨守成规之人：formal rules

predestine - (vt) 预先注定：in advance

pedestrian - 平庸无奇的，令人厌倦的：causing weariness
{行人}

peep - (n) 一瞥：brief look；
(n) 轻声：slight sound

peer - 同等地位的人，同辈：equal；
(vi) 好奇地凝视：look

peeve - (vt) 打扰，惹恼：disturb

pejorative - 轻蔑的，贬低的：disparaging

pellucid - 清晰明确的，易懂的：clear
{透明的：admitting light；}

plaintive - adj.悲伤的 expressing suffering

polymath - n.学识渊博的人，博学者 encyclopedic learning

penchant - (n) 嗜好，迷恋：strong inclination

penitent - 悔过的：regretful

pensive - 沉思的，（尤指）哀思的：thinking

penury - (n) 贫穷：dearth；
(n) 吝啬，节俭：frugality

perambulate - (v) 徒步穿越，走过：travel over

perceptible - 可察觉的：being perceived

peremptory - 不容反抗的：not allowing contradiction；
傲慢的：feeling of superiority
{爱发号施令的：ordering people}

perfervid - 非常热情的：exaggerated emotion

parochial - 狭隘的 not broad

perfidy - (n) 不忠，背信弃义：disloyalty

perforate - (v) 打孔，穿透：make a hole

perfunctory - 例行公事的，敷衍的：superficially；
不感兴趣的：lacking in interest

perimeter - 边界，界限：outer limit

periodical - 期刊：publication；
周期性的，有固定间隔的：regular intervals

peripatetic - 巡游的，四处游历的：place to place

peripheral - 辅助性的：supply
{外围的：boundary or periphery}

perish - (vi) 死亡，消亡：cease to exist

permanent - 永恒的：continuing or enduring, forever

permeable - 可渗透的：penetrated

pernicious - 有害的：injurious

patchwork - 混合物（的）：mixture of various things

perpetual - 永恒的，不断的：continuing forever

persecute - (vt) 迫害，折磨：cause suffering

persevere - (vi) 坚持不懈，不屈不挠：persist

persiflage - (n) 打趣：teasing

persistence - (n) 坚持，持续：lasting existence

personable - 风度翩翩的，吸引人的：attractive

perspicacious - 极敏锐的，有洞察力的：penetrating mental discernment

perspicuity - n.清晰明了：clearness and lucidity

pertain - 有关联的：have a relation

pertinacious - 顽固的，固执地坚持的：sticking

pertinent - 相关的，恰当的：relevance

penance - n.忏悔 show sorry about doing something wrong

peruse - (vt) 细读：examine with great care

pervade - (vt) 弥漫，充满：throughout

pessimistic - 悲观的：take the gloomiest possible view

petition - (n) 请愿，正式的申请，申请书：supplication or request；
(v)（尤指正式地）请求：,make a request

petrify - (vt) 使僵化，使失去活力：become stiff

petty - 细微的，不重要的：small importance

phenomenal - 不寻常的，非凡的：out of the ordinary

philanthropic - 博爱的，为他人着想的：welfare of others

philistine - 市侩（注重物质而鄙视智慧或艺术的人）：guided by materialism

phlegmatic - 冷静的，无感情的，淡漠的：calm, sluggish temperament

piddling - 微不足道的：trifling or trivial

piebald - 混合的，杂糅而成的：different sorts

pigment - 颜料：color；
(vt) 给...上颜色：color

pilfer - (vt) 偷窃：steal

precocious - adj.早熟的 before the usual

pillory - (vt) 当众嘲弄：public contempt

pilot - 初步性的，试验性的：tentative model；
(vt) 带领通过：lead
{领航员，飞行员：steer a ship；}

pine - (vi) 渴望，奢望：yearn；
{(vi) 因渴望而憔悴：lose vigor}

pinnacle - 顶峰：highest point

pinpoint - 非常精确的：extreme precision；
(vt) 精确定位或确认：identify with precision

piquant - 令人振奋的：provocative
{辛辣开胃的：pungent taste}

pique - (vt) 使愤怒：arouse anger；
(vt) 激起，刺激：excite or arouse

pirate - (vt) 盗版，盗用：without actual right；
{海盗：robber seas}

pithy - 精练的，简洁的：brief

pitiless - 没有同情心的：devoid of pity

pittance - 少量津贴：small portion

placate - (vt) （通过让步以）平息抚慰：lessen the anger

placebo - 安慰性的事物：used to appease or reassure

plagiarize - (v) 剽窃，抄袭：steal ideas

plastic - 可塑的：modified；
虚假的，做作的：lacking in natural

plangent - 凄凉的，哀伤的：plaintive

plateau - 高原：raised above；
稳定时期，平台期：stable level

platitude - 陈词滥调：banal statement；
缺乏原创性：lack of originality

plausible - 可信的{看似有理的}：superficially reasonable

plague - 瘟疫：widespread disease；
折磨，使痛苦：cause persistent suffering

poignant - 令人感伤的 causing sadness

plethora - 过量，过剩：excess

pliable - 易弯曲的，柔软的：supple；
易受影响的，温顺的：easily influenced

pliant - 易弯曲的：easily bent；
顺从的：yielding

plight - 困境：unfortunate

plodding - n.无聊的，单调乏味的 dullness, and monotony

pluck - 敢于面对困难的勇气：courage；
(v) 弹奏（弦乐）：strings pulling releasing

plumb - 完全的，绝对的：no exceptions；
(vt) 仔细深入地检查；探索，探究：examine deeply

plummet - (vi) 突然下降：decline suddenly

plump - 丰满的：well-around；
(v) 鼎力支持，赞不绝口：give full support

plunge - (vi) 突然下降：descend suddenly；
{(vt) 插入，刺入：penetrate}

polarize - (vt) 使分开对立，使两极分化：break into opposing

polemic - (n) 争执：argument

polished - 有教养的：high degree of refinement；
擦亮的：shiny

politic - 精明能干的：shrewdness；
合时宜的，明智的：suitable

pompous - 浮夸的：ornate；
傲慢的：self-importance
