entangle - vt.使变复杂或困难

episodic - 片段的，断断续续的：lacking in steadiness

entice - (vt) 诱使：tempt, lure

entrance - (vt) 使入迷：wonder, enchantment
{进入权，进入许可：means of entering or participation}

entrap - (vt) 诱骗：lure

entreat - (vt) 恳求：plead persuade, ask urgently

enunciate - (v) 清晰地说：articulate；
(vt) 公开宣布，宣称：openly or publicity

ephemeral - 短暂的：very short time

epic - 宏大的，超凡脱俗的：surpassing the usual

epicure - 美食家：discriminating tastes

epigram - 机智的短诗，警句：short witty

epilogue - 文学作品的结局：concluding section literary

epithet - 外号，绰号：descriptive name

epitomize - (vt) 代表，体现，是...的典型范例：represent a typical example of

equable - （脾气、性情）温和的：serene

equity - 不偏不倚，公平：lack of favoritism

equivalent - adj./n.等价的，相等的

equivocate - (vi)（带有欺骗目的地）模棱两可地说，说谎话：equivocal

empirical - adj.基于观察、实验的

errant - 居无定所的：from place to place；
误入歧途的，犯错误的：straying proper course or standards

erratic - 善变的：not constant

erudite - 博学的：learned

escalate - (v)（使）（战争等）升级，扩大：increase

eschew - (vt) 刻意避开；戒绝：avoid

esoteric - 深奥难懂的：difficult to understand

espouse - (vt) 支持；拥护：support

esteem - (v, n) 尊重：respect, prize

estimable - 值得尊敬的：admirable

estrange - (vt) 使疏远，离间，使感情失和：enmity, indifference, friendliness

etch - (v) 留下深刻印象，铭记：produce a vivid impression

eternal - adj.永恒的

ethereal - 轻巧精致的：lightness, highly refined, delicate
非物质的，精神（上）的：spiritual, not composed of matter

ethics - 道德规范：governing conduct

eulogize - (vt) 称赞，颂扬：speak in high praise of

euphemism - 婉言，委婉的说法：inoffensive expression

euphonious - 悦耳的：pleasing

euphoria - (n) 感觉极其愉快：overwhelming usually pleasurable

evacuate - (vt) 撤空：empty or remove；
(vt) 撤退：remove

evanescent - 逐渐消失的，短暂的：vanish

entail - (v)牵连，导致

everlasting - 永恒的，持久的：forever

evict - (vt) 赶出，逐出：expel

evince - (vt) 表明：make known

evoke - vt.唤起，引发

exacerbate - (vt) 使加剧，使恶化：severe

exacting - 严格的，苛求的：rigorous；
费时间心思的：requiring time, effort, attention

exalt - (vt) 赞扬：praise
{(vt) 提升，提拔：raise}

exasperate - (vt) 激怒：excite

excavate - (v) 挖掘，挖空：dig out

exceptional - 例外的，特别的，非凡的：uncommon, extraordinary

excoriate - (vt) 严厉批评：criticize harshly publicly

excrete - (vt) 排泄：discharge

excruciate - (vt) 折磨，使痛苦：pain

exculpate - (vt) 声明无罪；开脱，使无罪：clear fault guilt

excursive - 离题的；散漫的：passing

execrate - (v) 痛恨：dislike strongly

exemplary - 榜样的，值得效仿的：being a pattern, imitated；
作为警告的：warning

exempt - (vt) 使免除：release liability

exhaust - vt.耗尽

exhilarate - (vt) 使高兴；使兴奋：cheerful, excited

exhort - (vt) 敦促，力劝：urge strong

exigent - 紧急的：immediate

exodus - (n) 大批离去：departure

exonerate - (vt) 免除责备：free from blame

exorbitant - 过度的：exceeding the customary or appropriate limits

exotic - 外来的，不同寻常的：unusual

expansive - adj.话多的，健谈的 readiness to talk

expedite - (vt) 加快进程：speed up the progress

expediency - n.应急手段，权宜之计

expiate - (vt) 赎罪，纠正：extinguish the guilt

expire - (v) 断气，死亡：die；
(v) 到期：come to an end

explicit - 表达清晰的：fully revealed or expressed；
成熟的，完全形成的：fully developed

exploit - 英雄行为：notable act；
(vt) 最大程度地利用：employ

exponent - 倡导者，支持者：advocates

expurgate - (vt) 净化（书等），删去（不当处）：remove

exquisite - 程度强烈的：extreme；
精致精巧的：refined taste

extant - 现存的：not destroyed, extinct

extemporize - (v) 即兴表现：without prior preparation

extenuate - (vt) 减轻罪过：lessen the seriousness

extinct - 灭绝的：no longer existing

extinguish - (vt) 熄灭：put out；
(vt) 终止：bring to a complete end

extol - (vt) 赞美；吹捧：praise

extort - (vt) 勒索：force, intimidation

extract - (vt) 用力拔出：take out

encyclopedic - adj.全面的，百科全书式的 covering everything

extraneous - 无关的：no relevance；
非主要因素的：not essential

extravagant - 挥霍的：spending money freely；
过度的，不必要的：beyond normal acceptable limit

extricate - (vt) 使解脱，救出：free entanglement

exuberant - 非常高兴的，热情洋溢的：joyously, unrestrained

exude - (v) 分泌，流出：flow forth

exult - (vi) 感到欢喜：rejoice

fable - 寓言故事：story teach a basic truth；
神话，传说：story of supernatural happenings；
谎言，虚构：statement in order to deceive

fabricate - vt.捏造

facetious - 喜欢开玩笑的，轻浮的：joking

facile - 表面的，浅尝辄止的：lack of depth；
容易的，唾手可得的：easily accomplished

facilitate - (vt) 使变容易，促进：make easy

faction - 派系：a party that is often contentious

fallacious - 谬误的，不合逻辑的：containing fallacy；
{欺骗性的：tending to deceive}

fallow - 休耕的：untilled；
闲置的：not being in a state of use

fail-safe - 保险措施：to preclude loss or injury；
万无一失的：no chance of failure
