liberal - 思想前卫的：not bound；
慷慨的，大方的：generosity

libertine - 放荡不羁者：without moral restraint

licentious - 放荡的，性欲强的：lacking restraints

liken - (vt) 显示相似，把...比作：show as similar

limber - 可塑的，柔软的：flexible

limp - 柔软的，松散的：lacking firm
(vi) 跛行，艰难地行走：haltingly or unsteadily
{软弱的，没有精神的：lacking strength}

limpid - 透明清澈的：transparent clearness；
{镇定的，淡定的：free from agitation}

linger - (vi) 磨蹭，闲荡：proceed slowly

lissome - 柔软的：easily bent；
敏捷的，轻盈的：move with ease

list - (v)（使）倾斜：at an angle

lithe - 敏捷的，轻盈的：grace；
柔软的：easily bent

loath - 不情愿的，讨厌的：reluctant

loathe - (vt) 厌恶：dislike

lofty - 崇高的：elevated；
{高的：rising}
自大的：superiority

loll - (vi) 懒洋洋地行动：lazy；
(vi) 偷懒，打发时间：doing nothing

lopsided - 歪的，倾斜的：leaning；
不平衡的，不协调的：lacking in balance

loquacious - 话多的：excessive talk

loutish - 粗鲁的：awkward, stupid and boorish

lubricate - (vt) 使润滑：reduce friction

lucid - 表达清晰的，简单易懂的：easily understood
{有光亮的：suffused with light；
神志清楚的：full use of one's mind}

lug - (vt) 拖动，拉动：cause to follow；
(vt) 费力搬运：laboriously

lugubrious - （故作夸张的）悲哀的：mournful

lull - 相对平静时期，间隙：momentary halt；
(vt) 使镇静，使安心：free from distress

lullaby - 催眠曲：song lull sleep；
(vt) 使镇静，使安心：free from distress

lumber - 木材：tree logs；
(vi) 笨拙地行动：clumsiness；
(vt) 使负担（从而拖累）：burden

luminary - 杰出人物：eminence

lurch - (vi) 蹒跚：swaying

lurk - (vi) 潜伏：lie in wait

lush - 茂盛的：vigorously；
多产的：producing abundantly；
（声音、味道）优美的，令人愉悦的：appealing

lustrous - 有光泽的：shiny

luxurious - 豪华的：wealth and comfort；
奢侈的：excessive gratification

lyric - （可以哼唱的）小曲：musical composition；
如诗歌般流畅优美的：suggestive of poetry or music

macabre - 恐怖的：horror of death

macerate - (vt) 浸泡（以软化）：soaking or steeping

maculate - (vt) 使有斑点，弄脏；玷污，损坏：spot

maelstrom - 混乱、动荡的局势：turbulent
{漩涡：violent whirlpool}

magnificent - 壮丽的：strikingly impressive

maladroit - 笨拙的：lack of nimbleness

malaise - (n) 不舒服：bodily discomfort

malcontent - 不满分子：opposition；
不满的：dissatisfied

malicious - 恶意的：deliberately harmful

malign - 恶意的：cause suffering；
(vi) 诽谤：utter injuriously

malinger - (vi) 装病以逃避工作：pretend illness

malleable - 可塑的：capable of being shaped；
易控制的：capable of being controlled

malodorous - 恶臭的：unpleasant smell

mandatory - 强制的：forcing compliance

mangle - (vt) 弄砸：ruin
{(vt) 损毁，使伤残：injury}

mangy - 卑劣的：contemptible

mania - (n) 热衷，狂热：intense enthusiasm

manifest - 显然的，明显易懂：understanding；
(v) 显现，显露：make evident

manipulate - (vt) 巧妙操作：skillful；
(vt) 巧妙处理，暗中操控：deviously

mannered - 不自然的，做作的：artificial

manumit - (vt) 解放（奴隶）：release from slavery

manuscript - 手稿：written by hand

mar - 污点，坏点：spoils the appearance；
(vt) 破坏，削弱：impair

malfeasance - 非法行为：illegal behavior

martinet - 纪律严明之人：strict

marvel - 令人惊奇的事物：surprise, admiration or wonder；
(v)（因为壮观、美丽等而）表示惊讶：feel amazement

mash - (vt) 捣碎

masquerade - (n) 面具，伪装：display insincere；
(vi) 伪装，掩饰：disguise

mastery - (n) 技艺超群，精通：great skill

matriculate - (v) 入学；录取：admit or be admitted

maudlin - 过于感伤的：tearfully sentimental

maven - 专家：experienced

maverick - 特立独行之人：does not conform；
标新立异的，不合常规的：deviating

mawkish - 过度伤感的：sentimental

meager - 贫乏的：deficient

mean - 卑贱的：ignoble；
吝啬的：sharing little；
(v) 打算，怀有目的：purpose or goal；
(v) 意味着：convey, show or indicate

meander - (vi) 闲逛，漫步：aimlessly and idly

measly - 少得可怜的，微不足道的：small

measured - 深思熟虑的，审慎的：calculated

meddle - (vi) 干涉，管闲事：intrude

mediate - (vt) 调解，调停：bring about an agreement

mediocre - 平庸的，质量中等偏下的：moderate

medley - 大杂烩，混合物：mixture

meek - 顺从的：submissive
{谦恭的：humility}

meet - 合适的：very proper

mellifluous - （曲调）优美的：smooth and sweet

melodramatic - 感情夸张的，伤感的：exaggeratedly emotional

menace - (vt) 威胁，使处于危险：intention to harm

mendacious - 撒谎的，虚假的：lies

mentor - 导师：guide；
(vt) 教导，指导：give advice

mercenary - 唯利是图的，贪婪的：monetary or material gain
{（外国军队的）雇佣军：soldier hired}

mercurial - （情绪）善变的：changeableness of mood

merited - 应得的，理所应当的：what is called for

mesh - (v) 诱捕：catch

mesmeric - 令人着迷的，难以抗拒的：attracting
{催眠的，催眠术的：mesmerism}

metamorphose - (vt)（使）变形：change

metaphysical - 哲学上的，理论上的：idea；
非尘世的：beyond universe

meteoric - 流星般迅速而短暂的：brevity

methodical - 井然有序的，有条理的：systematic order

meticulous - 极为谨慎的：extreme or excessive care

mettle - 勇气：strength of spirit；
毅力，耐力：stamina

miff - (vt) 使恼怒：annoyed

migratory - 迁移的：moving from one region to another

milk - (vt) 榨取（财富、信息等）：coerce profit

mime - (v) 模仿：model

mimic - 仿真的，伪造的：in appearance；
(vt) 模仿：model
{(vt) 滑稽地模仿（以取笑）：copy or exaggerate}

minatory - 带来威胁的，有凶兆的：a sign of evil

ministration - n.帮助 aiding
