prowess - 英勇，勇敢：superior, courage

prowl - (v) 潜行于，巡游以猎取食物，徘徊：roam through search of prey

prude - 过分正经的人：一个过分关心自己是否得体、谦逊、或正确的人：greatly concerned seemly behavior and morally

prudent - 明智的：wisdom, judiciousness, wise；
小心谨慎的，审慎的：circumspection

prudish - 过分守礼的：prudery

prune - (vt) 修剪；修正

pry - (vi) 刺探，打听：inquire closely, curiously；

pseudonym - 假名，笔名：fictitious

putative - adj.推测的，假定的 regarded as such

pecuniary - adj.金钱上的 money

puckish - 淘气的，顽皮的：mischievous, impish

puerile - 幼稚的，不成熟的：immature

puissance - 权力：power

pulchritude - 美丽：beauty

pulverize - (vt) 将...研磨成粉；将...彻底摧毁：complete end

permeate - 弥漫，渗透：spread throughout

punctilious - 注意细节的，一丝不苟的：attentive details

pundit - 权威人士，专家：opinions authoritative

pungent - 辛辣的，讽刺的：use of wit cause hurt feelings

puny - 微小的，弱小的：inferior size, weak

purport - 声称，打算 state as a fact

purlieu - 常去的地方：socializing；
临近的地区：adjoining region

purloin - (vt) 偷窃：steal

purvey - (v)（大量）供给，供应：supply

pusillanimous - 懦弱的，胆小得令人鄙视的：timidity

quack - 骗子医生，江湖郎中：pretender

quaff - (vt) 大口地喝：drink heartily

quail - (vi) 胆怯，畏缩：fear, cower

qualify - (vt) 限定：reduce general；
(vt) 使有资格，使有能力：make competent

quandary - (n) 困惑，窘境：perplexity, doubt

quarantine - (n) 隔离：isolation

qualm - 担忧，不安：uneasy feeling

quash - (vt) 镇压，阻止：put a stop to

quirky - adj.古怪的，奇葩的 different from the ordinary

quell - (vt) 压制：suppress；
(vt) 使平静，使安静：pacify

quench - (vt) 熄灭：put out；
(vt) 使满足：put a complete end to

querulous - 抱怨的，爱发牢骚的：complaining

quibble - (vi) 吹毛求疵：criticize, cavil；
牵强之词：微不足道的差别或不切中要点的异议，小反对：minor objection

quiescent - 平静的，静止的：quiet, inactive

quixotic - 不切实际的，空想的：more by ideals than by reality

quota - (n) 配额，限额：proportional

quotidian - 每日的，平凡的：commonplace

rabble - 混乱的人群；暴民；下层群众：disorganized crowd of people

rabid - 狂热的，不冷静的：fanatical

racy - 活泼生动的：vigorous

raffish - 低俗的：crudeness

recapitulate - 概括，摘要：make into a short statement

rage - (v, n) 暴怒：violent anger

ragged - 衣衫褴褛的：threadbare clothes；
凹凸不平的，不光滑的：not smooth

rail - (vi) 猛骂，猛烈抨击：revile or scold

rakish - 放荡的，行为不检的：lowered moral character

ramble - (vi) 漫谈，长篇大论（并经常离题）地说或写：without a topic
{(vi) 漫步，漫游：move aimlessly}

rambunctious - 喧闹的，骚乱的：noisy

ramshackle - 摇摇欲坠的：ready to collapse

rancor - 敌意，深仇：ill will

random - 随机的，随意的：lacking pattern

rankle - (vt) 激怒：cause anger

rant - (n)（尤指长时间的）训斥，责骂：angry scolding
{(vi) 怒吼：noisy, angry or violent manner}

rapacious - 过度贪婪的：covetous
{食量大的，贪食的：huge appetite}

rapport - 和睦，友好：friendly relationship

rapprochement - 和睦，友好：cordial relations

rapscallion - 流氓，恶棍：evil

rapt - 狂喜的，狂热的：pleasurable emotion；
{全神贯注的：deeply absorbed}

rarefy - (vt) 使稀薄：make rare

rash - 草率的，仓促的：lack caution

raspy - 声音刺耳的：harsh；
容易生气的：easily irritated

ratify - (vt)（官方地）认可，批准：official acceptance

ratiocination - (n) 推理：thought processes

ration - (vt) 按比例分配：share or portion
{定额供应量，配给量：amount allotted}

rational - 合乎逻辑的：logical；
理性的：based on reasoning

rave - (vi) 狂热赞扬：exaggerated display of affection；
(vi)（发疯般的）怒吼：talk as if in delirium

ravel - (vt) 解开，松开：separate strands；
(vt) 阐明：clarity by separating；
(vt) 使纠缠，使复杂化：tangle

ravish - (vt) 使陶醉，使沉迷：overcome with emotion

raze - (vt) 摧毁，粉碎：destroy completely

row - 争吵，争执：expression of differing opinions

reactionary - 反对改革的，极保守的：opposition to progress

ream - (vt) 怒斥，训斥：criticize

ramification - 影响，结果：result

reassure - (vt) 使安心，打消疑虑：restore to confidence

rebuff - (vt) 严词拒绝：reject

recalcitrant - 顽抗的，不顺从的：resistance defiance

recant - (vt) 撤回，放弃，改变：withdraw a statement

recessive - 内向的，内敛的：not comfortable around people
{（基因等）隐性的，由隐性基因控制的}

recidivate - 回到原先的习惯，尤指重新犯罪：return to criminal habits

reciprocate - (vi) 往复运动：forward and backward；
(vt) 报答，回报：return

reckless - 不考虑后果的，大胆鲁莽的：careless

recluse - 隐士：lives away；
隐居的，不爱社交的：withdrawal from society

recoil - (vi) 退却，畏缩：shrink back

reconcile - (vt) 使和解，协调：harmony

recondite - 深奥的，难解的：difficult to comprehend

reconnoiter - (vt) 侦察，勘查：make a preliminary inspection

reconstitute - (vt) 重建，（尤其是通过加水）使复原：restore by adding water

reconvene - (v) 重新集合，重新召集：gather or summon again

repentant - 悔过的：feeling sorrow

rectitude - 正直：moral integrity

recumbent - 躺着的：lying down

recuperate - (v) 恢复（健康或力量），康复：recover health

redolent - 芳香的：fragrance

redoubtable - 杰出的，值得尊敬的：worthy of respect；
可怕的：arousing fear

redundant - 多余的，冗余的：exceeding necessary

reel - (vi) 感到眩晕：from being twirled around；
 {(vi) 蹒跚地走路：swaying from side to side}
