abreast - adj.熟知的

appurtenance - n.附属物

acclaim - n.称赞；vt.赞扬，赞颂

apostle - n.(政策或思想等的)信奉者，支持者

accord - n.一致；vi.相符合，相一致；vt.授予，给予

accustom - vt.使习惯

acquire - vt.获取，获得

acquisitive - adj.贪婪的

adjudicate - v.裁决，判定

adversity - n.厄运，逆境

affectation - n.虚伪，做作

affirm - vt.声称...为真，肯定...属实

affix - vt.粘合

affliction - n.痛苦，悲伤，折磨

agape - adj.急切盼望的

agility - n.(身手)敏捷

agonize - v.(使)非常痛苦

agreeable - adj.令人愉悦的；adj.相一致的

alienate - v.使...疏远

alloy - n.合金；混合物；vt.掺杂，降低...的纯度

ambivalent - adj.(尤指感情、态度)矛盾的

anachronism - n.不合时代的人或事物；过时现象；n.时代错误，年代误植(指所叙人、事与时代不符的错误)

analogous - adj.相似的，可比较的

annex - vt.添加，合并

annotate - vt.给...作注解

antedate - vt.比...早，早于

antipathy - n.厌恶，反感

antiquated - adj.古老的，过时的

antithetical - adj.完全对立的，相反的

apparition - n.鬼魂，幽灵

applicable - adj.可用的，可行的；adj.相关的，有关的

apprehensive - adj.知晓的，理解的；adj.恐惧的，害怕的

arable - adj.适合耕种的

arbitrary - adj.专横的，独断专行的；adj.缺乏计划的，随意的

arcane - adj.深奥的，难以理解的

argument - n.争吵，争论；n.(逻辑上的)论证

arid - adj.干燥的；adj.无趣的，无聊的

array - n.排列，阵列；vt.排列，摆放

assail - vt.抨击，严厉批评

atrophy - vi.萎缩，衰退

attest - vt.证实，为...作证

attune - vt.使协调，使和谐

august - adj.威严的，庄重的

auspicious - adj.好兆头的

austere - adj.朴素的，朴实无华的

automatic - adj.自发的，情不自禁的

avowal - n.承认，公开宣布

backfire - vi.产生相反的结果，事与愿违

backslide - vi.(情况等)倒退，变坏

baffle - vt.使疑惑

bohemian - n.特立独行之人

bash - vt.抨击，严厉批评

beholden - adj.欠他人人情的

behoove - vt.对...有利

beige - adj.缺乏特征的

bureaucratic - adj.官僚主义的

belligerent - adj.好斗的，好战的

beset - vt.使苦恼，骚扰；vt.攻击，袭击

bewitching - adj.迷人的，令人着迷的

blackmail - n./vt.敲诈，勒索

bluff - adj.直率的，(说话)直截了当的；vt.欺骗

bogus - adj.伪造的，假冒的

bore - n.令人厌烦的人或事物；vt.使厌倦，使厌烦

brandish - vt.(带有威胁性地)挥舞

brim - n.边缘，边界；vi.充满

bumble - vi.含糊不清地说，杂乱无章地说

bustle - n.忙乱，喧闹；vi.(快速地)行走，奔忙

calamity - n.大灾难

calculated - adj.经过计算(成败得失)的，经过深思熟虑的

canny - adj.精明的，聪明的

canonize - vt.使崇高，使神圣

captious - adj.吹毛求疵的，爱挑毛病的

careen - vi.蹒跚而行，不稳地行走

carefree - adj.无忧无虑的

cascade - n.一连串，大量

cellular - adj.多孔的

ceremonious - adj.讲究礼节的，庄重的

certitude - n.确信无疑

channel - vt.将...导向，投入

chaperone - vt.同行，护送

charisma - n.魅力，吸引力

cherished - adj.受喜爱的，珍爱的

chivalrous - adj.有骑士风度的，(尤指对女性)彬彬有礼的

chorale - n.赞美诗；n.合唱班，合唱团

clamor - n.喧闹，喧哗，噪声

clan - n.(有共同爱好的)团体，帮派

cleave - vi.紧贴，坚持；vt.分隔，割裂，劈开

cling - vi.紧贴；支持

coarse - adj.粗糙的，表面不平整的；adj.粗俗的

cohesive - adj.有粘性的；有凝聚力的

commiserate - vi.表示怜悯，同情 = condole

compatible - adj.一致的，能共存的

compelling - Adj.极具说服力的；吸引人的；强烈的

complacent - adj.自满的，自鸣得意的

complementary - adj.互补的

complicate - vt.使复杂化

comprehend - vt.理解，了解；vt.包括，包含

concrete - adj.事实性的，明确的

condemn - vt.谴责(...为不道德的、邪恶的)

conditional - adj.有条件的，受制约的
