barb - (n) 尖锐而严厉的批评：critical

barbarous - 野蛮的，凶残的：mercilessly;

barefaced - 公然的，厚颜无耻的：brazen

bargain - (n) 协议：agreement; 
(vi) 讨价还价：negotiate

baroque - 装饰华丽的，过分雕琢的，复杂的：extravagance, complexity, flamboyance; 
（程度上）过分的：beyond, limit

barrage - (n) 有压倒之势的、集中倾泻的（如言语）：overwhelming, outpouring;

barren - adj.无效的；
adj.贫瘠的

barricade - 障碍物：obstruction, rampart; 用障碍物阻止通过：prevent access

barter - (v) 以物换物：trade, without

beguile - v.欺骗 believe what is untrue

bathetic - 平凡的，陈腐的：commonplaceness

befuddle - v. 使困惑

bedeck - (vt) 装饰，点缀：make more attractive

belabor - (vt) （当众）严厉批评：criticize; 
(vt) 就···作过度的说明，喋喋不休：explain, excessively

beleaguer - (vt) 使困扰，使烦恼，使消沉：trouble

belie - (vt) 掩饰：shut off from view; 
(vt) 与···相对立，与···相矛盾：counter

bellwether - 领导者，带头人：lead

beneficent - 仁慈的，好慈善的：charity; 
（对个人或社会）有益的：contributing

benign - adj.无害的

berate - (vt)（长时间）严厉指责：scold, vehemently, at length

beseech - (vt)（急切地）恳求：beg

besmirch - (vt) 诽谤，玷污：detract from the honor

bifurcate - (v)（使）分成两支：two branches

bigot - 固执己见者，有偏见的人：obstinately devoted

bland - 味道平淡的，不刺激的：soothing; 
无趣的：dull; 
温和的，和蔼的：not harsh

blandishment - 甜言蜜语，讨某人好话：coax, cajole

blasé - （过度放纵之后）厌倦享乐的，腻厌的：apathetic

blast - (n) 爆炸：explosion; 
(vt) 斥责，抨击：criticize harshly

blatant - （让人生厌地）惹人注目的：noticeable

blazon - (vt) 使知名：make known openly; 
(v) 修饰，装扮：make more attractive

blemish - (n) 缺点，污点：imperfection; 
(vt) 损害，玷污：reduce

blight - (v) （使）枯萎：affect; 
(v) 损害：impair

bliss - 极度快乐：ecstasy; 
极乐世界：place of perfect happiness

blithe - 愉快高兴的：happy lighthearted; 
无忧无虑的，漫不经心的：freedom from worries

blueprint - v.事先计划

blunder - (n) 过失：error, mistake; 
(v) 在···方面犯了很愚蠢且通常很严重的错误，糟蹋：make a stupid, error;

blunt - (vt) 使变钝：less sharp; 
(vt) 减弱（力度等）：weaken in strength or feeling; 
直率的：direct, brief

blur - (v)（使）变得朦胧，（使）变得不清楚：vague; 
(vt) 使不易理解：unclear to the understanding

blurt - (vt) 突然说出，冲动地说：abruptly

bluster - (v) 狂妄自大地大声说：loudly arrogant; 
(n) 喧闹的状态：noisy

boggle - （因为怀疑、恐惧）犹豫：hesitate

boisterous - 喧嚷的，吵闹的：noisily

bolster - (v, n) 支撑（物）：provide support；
(vt) 鼓励、使有精力：boost

bombast - 夸大的言辞：pompous

bonhomie - (n) 温和，和蔼：geniality

boo - (v, n) 嘘（以表示不满或嘲笑）：contempt, scorn, disapproval

boon - 恩惠，福利：benefit

boorish - adj. 粗鲁无礼的：impolite

bootless - 无用的：useless

bound - (n) 界限：beyond which a person or thing cannot go; 
(vt) 给···设置界限：set limits; 
(adj)投入的，坚定的：fully committed

boycott - vt.联合抵制，拒绝参与

bracing - 令人振奋的，给人带来活力的：giving strength

brake - (v) 刹车：less rapid

brash - 愚勇的，鲁莽的：foolishly adventurous

brassy - 厚脸皮的，不知羞耻的：rude boldness;

bravado - (n) 假装勇敢：pretense; 
(n) 虚张声势：swaggering

bravura - (n, adj) 优秀演技（的）：brilliant

brazen - 蛮横大胆的，厚颜无耻的：contemptuous boldness; 
(v) 大胆自信地去面对或从事：bold self-assurance

breach - (n)（对伦理、法律准则的）破坏：breaking, moral or legal code; 
(v) 违背：fail to keep

brevity - n.简短，简洁

bribe - (v) 贿赂，收买：give, money

bridle - (v) 限制

brisk - 充满生机的，有活力的：activity; 
（言辞或方式）尖刻辛辣的，刻薄的：keen or sharp

bristle - (v) 怒不可遏，咆哮：anger; 
(v) 供应充足，充满：copiously

brittle - 易碎的，脆弱的，易坏的：broken; 
不热心的，不真心的：lacking in friendliness

broach - (vt) 提出讨论：present

bromide - 陈词滥调：hackneyed

brook - (vt) 忍受，容许：tolerate;

browbeat - (vt) 恐吓：intimidate

bruit - (vt)（未经证实地）散播（消息）：make, the subject of common talk

buck - (v) 阻止，反对：refuse assent; 
(v) 转移，交接：shift possession

budge - (v) 停止抵抗，屈服：cease resistance

bulge - (n) 凸起：protuberant; 
{(n) 比赛中的优势地位：more favorable condition; 
(n) 暴涨，突增，在数目或数量上突然而且是临时性的增加：sudden, usually temporary increase; 
(vi) 充满：copiously supplied}

bully - (n) 欺凌弱小者：intimidating manner; 
最好的，最棒的：best

bumptious - 专横傲慢的，自以为是的：superiority

bungle - (vt) 办遭，失败：work clumsily

buoy - (vt) 使充满勇气和力量，使振作：courage or strength

buoyant - 有浮力的：floating; 
心情好的：good mood or disposition

burgeon - (vi) 迅速成长扩大，蓬勃发展：grow, rapidly, flourish

burlesque - (v, n) 夸张滑稽地模仿以嘲弄他人的文学艺术作品，恶搞：make fun of

burnish - (v) 擦亮，磨光：make smooth or glossy

buttress - 为···提供支撑的证据或者信息：provide evidence or information for

byzantine - 错综复杂的：complicated, secretive, interrelated

cache - (n) 囤货，藏货：supply; 
(v) 隐藏：hiding

cachet - (n) 同意：approval; 
(n) 声望：prestige

cacophony - 刺耳的声音：inharmonious sound

cavalier - 有骑士精神的人，彬彬有礼的绅士：a courtly gentleman

cajole - (v) 哄骗：wheedle

calcify - (vt) 使僵化：inflexible, unchangeable

calibrate - (vt) 调整，使标准化：standardize; 
(vt)（根据标准）精确测量：measure precisely

calligraphy - （优美的）书法：elegant handwriting

callous - 无同情心的，冷漠的：unfeeling

callow - 不老练的，不成熟的：lacking, experience

calumniate - (v) 诽谤，造谣，中伤：false statements

camaraderie - 友情：friendly

catharsis - n. 情绪的宣泄

camouflage - (v, n) 伪装，伪装手段：deceive, hide

canard - (n) 谣传，误传：misleading

candor - (n) 坦率，直率，诚挚：honest, sincere

canon - 准则，标准：standard, criterion; 
真经，正典：authentic
