creep - (vi, n) 缓慢地行进：slowly；
(vi) 匍匐前进：body close to the ground

crescendo - (v, n)（声音）渐强：gradual increase；
(n) （渐强之后到达的）顶峰：peak

crest - 顶部，浪尖，山顶

crestfallen - 垂头丧气的，沮丧的：depressed

cronyism - (n) 任人唯亲，对好朋友的偏袒：favoritism friends

crook - (vt) 使弯曲：away from a straight line

croon - (v) 低声歌唱或说话：murmuring

culminate - v. 达到高潮 triumphant conclusion

crucial - adj.非常重要的，决定性的

crumple - (v) 弄皱：bend；
(v)（因外力挤压而）垮塌：fall down

crutch - (v, n) 支撑，支柱：supports

crux - 中点，关键点：critical point

cryptic - 秘密的：secret
以理解的：beyond one's powers to know

culpable - 该受谴责的，有罪的：deserving blame

cultivate - (vt) 提升，加强：improve；
(vt) 种植，培养：promote growth

cumbersome - 笨重的，难处理的：difficult to handle

cunning - 狡猾的：artful deceptiveness；
(n) 欺诈，欺骗：practice of misleading

curmudgeon - 脾气坏的、爱抱怨的人：irritable and complaining

cursory - 匆忙的，不注意细节的：excessive or careless speed

curt - 言词简略的，直接（以至显得粗鲁）的：direct, brief, and potentially rude；
言简意赅的：convey much information

curtail - (vt) 缩短，削减：less in extent or duration

cynic - n.反人类的喷子

dabble - (vi) 涉猎，对...浅尝辄止：superficially

daft - 不明智的：lack of good sense or judgment

dazzling - adj. 炫目的，耀眼的 reflecting much light

dally - (vi) 虚度时光：doing nothing；
(vi) 玩乐：amusement；
(vi) 慢吞吞，磨磨蹭蹭：slowly

damper - 抑制因素：restrains, depresses

dandy - 纨绔子弟，爱打扮的人：appearance

dank - 阴湿的：wet

dapper - 衣冠整洁的：strikingly neat and trim

dappled - 有斑点的，花的：marked with small spots, mottled, spotted；
色彩斑斓的：two or more colors

daredevil - 大胆鲁莽的（人）：foolishly；
不考虑后果的：a lack of concern for the consequence

dart - (vi) 突然移动，猛冲，狂奔：suddenly；
(n) 公开侮辱：intended to hurt another's feelings

daunt - (vt) 使胆怯，吓到：to lessen the courage

dawdle - (v) 闲荡，虚度光阴：spend time idly；
(v) 拖拖拉拉：slowly

deadpan - 无趣的，无生气的，不活泼的：impassively

dearth - (n) 供应不足：inadequate

debacle - (n) 溃败：complete failure

debark - (v)（使）下船（飞机、车等）；卸（客、货）：unload, from a ship or an airplane

debase - (v) 贬低，贬损：lower standing

debilitate - (vt) 使衰弱：impair strength

debris - 废墟：discarded, useless material

debunk - (vt) 揭穿...的真面目：true nature；
(vt) 证明...为假：false

debut - (n) 初次登台，出道：first appearance

decadence - (n) 衰落，颓废：deterioration, decline

detest - v.厌恶

decant - (vt) 轻轻倒出：pour off without disturbing

decode - (vt) 解码：change into ordinary language；
(vt) 对...有清晰的想法，理解，解读：clear idea

decorum - 礼仪，得体：appropriateness, propriety

decrepit - 虚弱的，衰老的，破旧的：weakened

default - (n) 不履行义务，玩忽职守：nonperformance

defer - (v) 推迟，延期：postpone；
(vi) 遵从：respect

document - v.证实

deficiency - (n) 缺乏，不足：inadequate

devious - adj. 狡猾的 lie and trick

deft - 灵巧的，熟练的：skill

defuse - (vt) 抚慰，减轻：make less tense

defy - (v)蔑视 confront with resistance
{(vt) 反抗，违抗：go against}

dehydrate - (vt) 去除水分，使干燥：remove water；
(v) 使失去活力：deprive of vitality

deify - (vt) 尊敬，尊崇：high status or value to
{(vt) 把...当作神来崇拜：offer honor or respect to}

deject - (vt) 使沮丧：lower the spirits, dishearten

deleterious - 有害的：harmful

deliberate - adj.深思熟虑的

delicacy - n.(外貌、结构等)精致

delirium - (n) 精神错乱；极度兴奋，发狂：mental disturbance confused

delusion - 错觉，妄想：false

deluge - 大暴雨：drenching rain；
大量：great flow

delve - (v) 探究，钻研：detailed search for information

demagogue - 蛊惑民心的政客：leader false claims

demanding - 难以取悦的，难满足的：satisfied；
费时间花心思的：requiring careful attention

demolition - (n) 破坏，毁坏：destroying

demonstrate - (vt) （通过证据）证明，表明：make clear using examples；
(vt) 使明白易懂：make plain or understandable

demoralize - (vt) 使士气低落：dishearten；
(vt) 贬低，使堕落：lower in character

demotic - 通俗的，大众化的：common

demur - (vi, n)表示异议，反对：opposition, objection；
(n) 犹豫：doubt acceptability qualm

denigrate - (vt) 诋毁，污蔑：scornfully

disingenuous - (adj)不真诚的，假惺惺的 not truly honest

denounce - (vt) 公开指责：public or formal disapproval；
(vt) 宣称...道德上错误、可耻：morally wrong

dent - (n) 凹陷，凹痕：depression；
(vt)（数量，程度上）削弱：make smaller

denude - (vt) 脱去，使赤裸：bare

deplete - (vt) 耗尽，使衰竭：make complete use

deplore - (v)谴责，强烈反对: hate or dislike very much
{(vt) 哀悼：sorrow}

deploy - (v)（有目的地）展开；调度，部署：spread out

deportation - (n) 放逐：removal from a country

depose - (vi) 宣誓作证：testify；
(vt) 废黜，罢免：remove from a throne

deposit - (n) 自然积累，沉积，矿藏：accumulation；
(vt) 存钱：put in account

depravity - 道德败坏：immoral, harmful or offensive

deprecate - (vt) 不喜欢：unfavorable opinion；
(vt) 贬低，轻视：express scornfully

depreciate - (vt) 贬低...的价值：lower value；
(vt) 轻视：lower estimation, esteem

depressed - 不开心的，情绪不高的，消沉的：unhappiness；
生活境况悲催的：healthful environment

deprivation - 匮乏：privation

deracinate - (vt) 根除：pull out

derelict - 玩忽职守的，不认真的：lacking duty, carelessly；
被社会遗弃的人：social misfit

deride - (vt) 嘲弄，嘲笑：contemptuous mirth

derivative - 非原创的：originality

descend - (v) 下降：downward；
(v) 世代相传：pass by inheritance

divination - 预言: foretelling future

desecrate - (vt) 亵渎，玷污：treat shamefully

desiccate - (vt) 使（食物）脱水以保存，使干燥：drying；
(vt) 使缺乏活力：deprive vitality

designate - (vt) 任命：to pick for a specific position or duty；
(vt) 命名：give a name to

decorous - adj.得体端正的

decipher - vt.破译；
vt.对...有清晰的想法，理解，解读
