amorphous - 无固定形状的：definite, shapeless; 
不可归类的：unclassifiable

anodyne - adj.无害的 not causing hurt

anarchist - 反抗权威的人：rebels against any authority

anathema - n.令人讨厌的事物

ancillary - 次要的：secondary importance;
辅助的，补充的：auxiliary, supplementary

anecdote - 短小有趣的故事：short narrative, interesting, amusing

anemic - 缺乏力量、活力、精神的：lacking force

anesthetic - 止痛剂：relieves pain; 
无感觉的，麻木的：lacking awareness or sensitivity

animate - (vt) 使有活力，支持：spirit support; 
(adj)有活力的：high-spirited energy

animus - 敌意：spiteful, malevolent, enmity

annoy - 不断烦扰

annul - (vt) 宣告无效，取消：legally invalid; 
(vt) 抵消：balance, ineffective

anomalous - 不普通的,不平常的：out, ordinary;

anonymous - 匿名的：not named, identified; 
无特色的：lacking individuality

antagonize - (vt) 与...敌对，反对：opposition, counteract; 
(vt) 激怒：incur, provoke, hostility

antediluvian - 非常古老的，过时的：extremely old, antiquated; 
保守的人：old-fashioned

anterior - 前面的：before

antic - 滑稽可笑的：clownish

apathy - 缺乏兴趣 冷漠 不关心

aphorism - 格言，警句：short witty

apocalyptic - 预言的，启示的：prophetic; 
重要的，转折点的：major turning

apocryphal - 假的：doubtful authenticity, spurious

apoplectic - 极度愤怒的：extremely angry, furious

apostasy - (n) 变节，背叛：abandonment, previous loyalty
(n) 放弃宗教信仰：renunciation, faith;

appall - (vt) 使惊恐：consternation

appeal - (n) 申请：application; 
(n) 起诉：charge, crime, accuse

appealing - 吸引人的：attractive, inviting

applause - (n) 鼓掌，认可：approval

apposite - 相关的，合适的：pertinent, appropriate

appreciable - 可感知的，明显的：perceptible

apprehension - (n) 忧虑，恐惧：suspicion, fear; 
(n) 理解：understand

apprise - (v) 通知，告知：inform

approbation - (n) 同意：approval

appropriate - (v) 私自挪用：take possession, without permission; 
适当的：suitable, fitting

apropos - 相关的：relevant; 
(prep) 关于，有关：having to do with

apt - 恰当的，合适的：suitable, appropriate; 
聪明的：intelligent, responsive

archaic - 过时的，久远的：no, current, antiquated

archetype - 典范，榜样：ideal; 
先驱，鼻祖：earlier; 
原型：copies

ardor - (n) 狂热：strong enthusiasm, devotion, zeal

arduous - 难以做到的，费劲的：difficult

anthropogenic - adj.人为的 influence of human beings

arrest - (vt) 使不活跃：inactive; 
(n, v) 停止：stopping, standstill; 
(v) 逮捕：keep; 
(v) 吸引（某人）注意力：hold, attention

arresting - 吸引人的：attracting, striking

arrhythmic - 不规律的：lacking, regularity

arrogance - 傲慢，自大：overbearing pride

articulate - 清晰地表达：clearly, distinctly; 
表达清晰的：able, express, clearly

ascendant - 有影响力的，主宰的：dominant, influence, superior; 
上升的：upward, rising

ascetic - 自制的（人）{苦行的，克己的，禁欲的：self-denial; 禁欲者：person, self-discipline}

aseptic - 消毒的，无菌的：preventing infection; 
缺乏活力的：lacking vitality; 
冷漠的：lacking emotion

askew - 不成直线的（地），歪的（地）：awry

aspect - 外表，容貌：appearance

asperity - （举止、性情）粗暴：roughness; 
（环境）艰苦：rigor, severity

aspersion - (n) 诽谤，中伤：harm, reputation

aspirant - 有抱负者，有野心者：aspires; 
想成为···的：seeking

assent - (vi) 同意：agree

assert - (vt) 断言，肯定地说出：declare, forcefully, aggressively

assertive - 自信的：bold, assertion, self-assured

assess - (v) 评估（重要性、尺寸、价值等）：determine; 
(v) 征收费用（如罚款）：charge, penalty

assiduous - 勤勉的，专心仔细的：careful

assuage - (vt) 缓和，减轻：lessen, intensity; 
(vt) 平息，抚慰：pacify, calm; 
(vt) 使满足：satisfying

astounding - 令人吃惊的，出乎意料的：astonishment, amazement

astute - 机敏的，有洞察力的：shrewdness, perspicacity

asunder - (adv) 分离地：apart
{(adv) 分离成多部分或多片地：separate parts, pieces; }

asylum - 收容所，保护所：refuge, protection

asymmetrical - 不平衡的，不对称的：no balance, symmetry

atone - (v) 赎罪，弥补：amends

atrocious - 极坏的，极其残忍的：extremely wicked; 
让人极为不满的：extremely unsatisfactory

attenuate - (v) 降低（数量、力量、价值）：lessen

audacious - 大胆的，（但往往）愚勇的：fearlessly, recklessly; 
蔑视（法律、礼节）的，无礼的：contemptuous of law; 
乐于冒险的：take risks; 
大胆创新的：verve

augur - 预言家：predicts; 
(vi) 出现好兆头：signs of, successful outcome; 
(vt) 预言：tell, beforehand

authentic - 真实的，非仿造的：exactly; 
准确的，相符的：original

authority - n.(某领域的)权威人士；
n.管辖权，控制

autocracy - 独裁政府：government, unlimited power

autonomy - n.政治上的独立；
n.自我主导的自由，(尤其是)精神独立

avarice - (n) 贪财，贪婪：insatiable

aver - (v) 声称为真：state, forcefully; 
(v)（态度强硬而明确地）声明：state clearly

averse - adj.反对的 dislike

avid - 急切渴望的：enthusiasm; 
贪婪（钱财）的：eager, for material possessions

awash - 被淹没的：by water; 
（如洪水般）泛滥的：filled, covered, overrun

awe - (v, n) 敬畏：dread, veneration, wonder

awkward - adj.缺乏灵活性和技巧的；
adj.(处理问题)缺乏手段和智谋的

avant-garde - n.(艺术)先锋派

awry - 弯曲的，扭曲的：turned, twisted; 
走样的（地），出差错的（地）：off, course

axiomatic - 公理的：axiom; 
不言自明的：self-evident

babble - (v) 发出含糊无意义的嘟囔声，胡乱说：utter, meaningless; 
(v) 闲聊：rambling conversation

backhanded - 间接的，含沙射影的，虚情假意的：indirect

badger - (vt) 不断纠缠或骚扰：harass, persistently

badinage - (n) 打趣，善意的玩笑：banter

bait - (vt) 逗弄，激怒：persecute, exasperate; 
(vt) 引诱：lead away; 
(n) 诱饵：something, luring

bale - 痛苦，悲哀：sorrow

baleful - 有害的：harmful; 
凶兆的，凶恶的：evil; 
致命的：causing death

balk - (vt) 阻碍：check, obstacle; 
(v) 不愿接受，拒绝：unwillingness

balky - 不服管束的，倔强的：refusing

balderdash - n.胡言乱语，废话，无意义的话

balloon - (v) 迅速增加：increase

balm - 香油，止痛膏，安慰物：sweet-smelling oil, soothe; 
香气：pleasant smell

banal - 非原创的，陈腐的：trite

bane - 祸根：ruin; 
有害物质：kill or injure a living thing

banish - (vt) 驱逐出境：leave, country; 
(vt) 赶出：force out

banter - (v, n) 幽默、打趣的（地）谈话：humored
