doff - (vt) 脱下：take off, remove

dogged - 坚持的，坚决的：continuing, slackening, yielding]；
固执的，任性的：sticking to

dogmatic - adj. 武断的，自以为是的 strongly held opinions

doldrums - (n) 低迷，中断：inactivity；
(n) 情绪不佳：low spirits

dolorous - 忧伤的：misery, grief

dolt - 笨蛋：stupid

domicile - (vt) 为...提供住处：provide domicile

dominant - 处于支配地位的：controlling others；
（基因）显性的：genetic dominance

don - (vt) 穿上：put on

donor - 捐赠人，给体：donates

doodle - (vi) （无目的）地乱涂乱画：aimlessly；
(vi) 漫无目的地打发时光：aimless activity

dormant - 静止的，不活跃的：inactivity；
（动物）冬眠的：suspended

dour - 闷闷不乐的，死气沉沉的：gloomy；
严厉的：harsh

douse - (vt) 熄灭：put out；
(vt) 弄湿：wet

downplay - (vt) 轻描淡写，不予重视：minimize significance

doom - 注定（倒霉）：determine the fate

doyen - 有经验的人，资深人士：knowledge experience；
（加入时间较长的）高级会员：senior member

doze - (vi, n) 小憩：lightly

draconian - 极其残酷的，十分严厉的：harsh

drawl - 慢吞吞地说：speak slowly

dreary - 单调乏味的：nothing cheer；
令人不悦的：causing unhappiness

drench - (vt) 使湿透，浸透：wet thoroughly

drivel - (n) 胡言乱语：meaningless；
(v) 胡言乱语，说傻话：talk stupidity

diminutive - adj. 小小的 less than average

drollness - 搞笑，逗逼: amusing

drone - (v) 低沉单调地说；嗡嗡地叫：talk monotonous；
(vi) 混日子：doing nothing

drudgery - 苦工；单调、卑贱或无趣的工作：tedious work

dubious - 充满不定性的，值得怀疑的：uncertainty, questionable；
（对事实等）持怀疑态度的：not feeling sure；

ductile - {可塑的，有延展性的：malleable}
易受影响的：easily led

dulcet - 悦耳的，令人愉悦的：melodious

dullard - 笨蛋：stupid

dupe - 复制品，复制：exactly like something else；
易受骗的人：easily deceived；
(vt) 欺骗：deceive

duplicitous - 两面派的，奸诈的：cheating

dwindle - (vi) 逐渐减少：gradually less

dyspeptic - 脾气坏的：bad-tempered；
消化不良的：dyspepsia

earnest - 严肃认真的：serious

embryonic - adj. 初期的，萌芽阶段的 early stage

earsplitting - 震耳欲聋的：distressingly loud

eavesdrop - (vi) 偷听：listen secretly

ebullient - 热情奔放的：zestfully

eccentric - 行为出格的，不循规蹈矩的：deviating conventional

éclat - 辉煌成就：success

eclipse - (vt) 使声望下降，使黯然失色：diminish importance；
{(vt) （在数量、品质上）超越：be greater}

ecstasy - (n) 狂喜：intense joy
{无法自控的情绪：beyond self-control}

ecumenical - 全球基督教会的：whole churches；
世界范围的，普遍性的：worldwide

edible - 可食用的：eaten

edifice - (n) 大厦；大建筑物：massive structure；
(n) 基础，基本结构：basic form

efface - (vt) 擦掉，抹去；使不明显：make indistinct

effervesce - (vi) 兴奋，热情洋溢：high spirits

effete - 衰弱的，衰落的：depleted

effluvium - 难闻的气味：offensive smell；

effrontery - (n) 厚颜无耻，放肆大胆：disregard, courtesy

effulgent - 光辉灿烂的：resplendent

effusive - 感情泛滥的／溢于言表的；感情表达不节制的／过度的；过分多情的:unrestrained in emotional expression

egalitarian - 平等主义的：promoting equal rights

egoistic - 利己的，以自我为中心的：centered in oneself

elaborate - 详细的，复杂的：complexity；
(vt) 详细阐述：in detail

elastic - 有弹性的：resuming shape；
能（迅速从伤痛中）恢复的：recovering from depression

elate - (vt) 使开心，使自豪：fill with joy

eleemosynary - 慈善的：charity

elegy - 哀歌（诗），挽歌（诗）：expressing sorrow

elephantine - 巨大的：enormous size；
笨拙的：clumsy

elevate - (vt)（在道德、智力、文化水平上）提升：improve；
(vt) 使兴奋：raise spirits

elicit - (vt) 激起，唤起：bring out

elliptical - 含糊不清的：obscurity；
椭圆的：ellipse

elucidate - (v) 阐明：make lucid

emaciate - (vt) 使消瘦，使衰弱：become thin；
(vt) 削弱：feeble

emancipate - (vt) 解放，解除束缚：free

embargo - 贸易禁止令：prohibition on commerce

embark - (vi) 上船：go abroad；
(vi) 开始从事：start

embarrass - (vt) 使尴尬：experience distress；
(vt) 阻挠，制造障碍：create difficulty

embed - (vt) 嵌入：enclose

embezzle - (vt) 盗用：appropriate

embolden - (vt) 鼓励，使大胆：instill courage

emboss - (vt) 以浮雕效果妆点，装饰：ornament with raised work

embrace - (vt) 乐于接受：willingly, eagerly；
(vt) 包围：surround

embroider - (v) （时常伴有夸张和想象内容地）详细说明：give elaborate account

emigrate - (vi) 移民，移居海外：leave

eminent - 杰出的：above others

emollient - 起缓和作用的：less intense

emulate - (vt) 效仿(并努力超越)：excel through imitation

enact - (vt) 制定或颁布（法律）：establish

enamel - (vt) 涂亮漆；使具有光滑或亮泽的表面：give a glossy surface；
(vt) 用亮丽的表面装饰：adorn

encomium - 赞颂之词：praise

encompass - (vt) 组成，包含：include；
(vt) 包围：envelop

encumber - (vt) 阻碍，妨碍：impede；
(vt) 给...增添负担：place burden

endemic - 地方性的：to a particular region

endorse - (vt) 公开支持，推崇：express approval

enervate - (vt) 使衰弱：weaken；
(vt) 使麻木：deprive of emotional vitality

enfranchise - (vt) 给予...权力（例如选举权）：endow rights；
(vt) 解放：set free

engender - (vt) 引起，使发展：cause

engross - (vt) 使全神贯注：occupy exclusively

enigma - 难以理解或解释的事物，谜：hard to understand

enlighten - (vt) 使知道，启发：inform, instruct；
(vt) （在道德或精神上）进行教育：provide moral understanding

enmity - 敌意：mutual hatred

ennoble - (vt) 使尊贵：noble

ennui - (n) 倦怠；缺乏兴趣：listlessness, lack of interest

expostulate - 争论，狡辩: to reason, dissuasion

ensconce - (vt) 安置：settle securely；
(vt) 隐藏：hiding

ensue - (vi) 紧随其后：afterward
