canvass - (v) 仔细检查，详尽讨论：examine carefully or discuss thoroughly; 
(v) 游说，去（一个地区）的各处或找到（个人）来拉选票或订单：solicits votes or orders

capitulate - (v) 投降，默许：give all resistance

caprice - (n) 一时冲动的决定：impulsive change; 
(n) 反复无常，善变：change, impulsively

captivate - (vt) 吸引：attract

careworn - 忧心忡忡的，焦虑的：grief, anxiety

cardinal - 主要的，非常重要的：foremost importance, paramount

caricature - (n) 用讽刺歪曲等手法的夸张，漫画，讽刺画：exaggeration
(v) 嘲笑性模仿或夸张：copy, exaggerate

carnal - 肉体的，物质的：physical; 
世俗的：worldly

carouse - (vi) 畅饮，狂欢作乐：drink, freely

carp - (vi) 对小事吹毛求疵，挑剔，表现不满：peevish criticism, objections, express dissatisfaction, tiresomely

cliquish - (adj)小集团的：very close association

cast - (vt) 提出：give off; 
(v) 抛弃：get rid of
{(n) 演员，演员阵容：a set of characters}

castigate - (vt) 强烈（公开）指责：criticize;

catalyze - (vt) 成为···的导火索，导致：be the cause of

catastrophe - 大灾难：tragedy; 
彻底的失败：utter failure

categorical - 没有例外的，无条件限制的，绝对的：without, qualification, absolute

catholic - 普遍的，包容的：not limited or specialized

caustic - 挖苦讽刺的，刻薄的：incisive sarcasm

caveat - (n) 警告，告诫：warning of a specific limitation

cavil - (vi) 挑剔，吹毛求疵：quibble

cataclysmal - 灾难性的: ruin

cede - (vt)（根据条约）放弃，割让：surrender possession of

cement - (v, n) 粘合，粘合剂：uniting, binding

censor - (vt) 审查并删除不良的东西：examine, delete

concomitant - (adj)伴随的，同时发生的：same time

censure - (v) 公开表示反对，谴责：public, formal disapproval

chic - (adj)时髦的，潮的：current fashion

cessation - (n) 终止，暂停：stopping of a process

chaff - (v) 开玩笑：make jokes

chagrin - (n) （因为失败、出糗而导致的）不安，焦虑：distress of mind

chameleon - (n) 变色龙，善变的人：changes or adopts opinions

champion - (vt) 支持：support

compulsive - (adj)不能自拔的：irresistible urge

chimera - n.虚构的事物，幻觉: illusion or fabrication

charlatan - (n) 骗子，装懂的人：fraudulent

chary - 非常谨慎的：cautious

chase - (v) 镂雕（金属）以装饰：decorate; 
(v) 驱赶：force out

chasm - (n) 分歧，（意见、利益或忠诚上）明显差异：pronounced difference

chauvinistic - 盲目爱国的：excessive favoritism

check - (vt) 使突然停止，阻止：arrest, abruptly; 
(v) 同意，一致：agreement

cherubic - 天使般可爱的：rosy

chicanery - (n) 诡计多端，欺骗：deception

chide - (v) 责备：scold mildly

choleric - 易怒的，暴躁的：angered; 
生气的：anger, irate

chord - (vi) 与···和谐一致，符合：accord, agree

chromatic - 彩色的：colors

chronic - 经常发生的，复发的：frequent recurrence;
习惯性的，不可能改变的：not likely, change

churlish - 粗鲁无礼的

cipher - {(v) 计算（价值）：determine, mathematical operations}
密码：conceal

circuitous - 迂回的，不直接的：not, forthright, direct;

circumlocution - (n) 绕圈子说话：unnecessarily, indirect, evasion; 
(n) 冗长：too many

circumscribe - (vt) 限制：limit; 
(vt) 包围，围绕：surround

circumspect - 谨慎的，小心的：careful

circumvent - (vt) 躲避，不遵从：avoid, comply

civility - 彬彬有礼：courteous, politeness

chokehold - n.压制

clandestine - 隐藏的，秘密的：secret, illicit, improper

clarion - 清楚响亮的：loud, clear

clarity - 清晰，清楚：clear, lucidity; 
清澈透明:easily seen through

clasp - (v, n) 紧握：holding

clement - 宽容的，善良的：tolerant, kind; 
气候温和的：neither, high, low

cliché - (n, adj) 陈词滥调（的）：hackneyed

clog - (n) 阻碍物：something, movement, progress difficult; 
(v) 阻碍：difficulty; 
(v) 堵塞：prevent, through

clot - (n) 密集的一群：a number of things, a unit; 
(v) 堵塞：prevent, through, filling with something; 
(v) 凝结：jelly

cordial - adj.热情的，友好的；
adj.令人振奋的，令人焕然一新的

clout - 权力，影响力：influence

cloying - 甜得发腻的，感情用事的：sweet, sentimental

clumsy - 笨拙的：lacking, nimbleness, lack, skill; 
不精致的：roughly

coagulate - (v)（使）凝结，（使）变稠：coherent, clot

coalesce - (v)合并，融合：whole, fuse

coax - (v) 哄骗：pleading, flattery, cajole

coda - 终曲：concluding passage

coerce - (vt)（以武力）强制：force, threat

coeval - 同时代的，同龄的：equal age

cogent - 令人信服的：convincing; 
相关的：pertinent

cognizant - 知道的，意识到的：aware

collapse - {(vi) 突然倒塌或收缩：fall, shrink; 
(n)完全耗尽体力：depletion, energy, strength} 
(v, n) 失败：unsuccessful

collude - (v) 串通，共谋（做坏事）：together secretly, fraudulent, deceitful, conspire

colossal - 巨大的：size, degree, immense

coltish - 不守纪律的：not subjected, discipline; 
爱开玩笑的：joking, teasing

coma - (n) 昏迷，深度无知觉：profound unconsciousness; 
(n) 迟钝，冷漠：sluggishness

combustible - 可燃的：igniting; 
容易激动的：easily excited

cluster - n.一群人

comity - (n) 友好，社会和谐：friendly, harmony

commencement - 开始：beginning; 
毕业典礼：conferring

commend - (vt) 赞扬：approbation, praise; 
(vt) 推荐：recommend

commensurate - 同样大小的：equal; 
相称的，相当的：proportionate

commingle - (v) 充分混合：blend

commitment - (n) 致力，投入：obligated, impelled; 
(n) 承诺，表态：revealing one's view

committed - 忠诚的，忠实的：loyal

commodious - 宽敞舒适的：spacious

commonsensical - 符合常识的，有依据的：common sense, sound

commotion - (n) 骚乱：disturbance

compendium - 摘要：summary, abstract; 
目录，各种各样的列表或集合：list, collection

complacency - 自满，无忧患意识：self-satisfaction, unawareness of trouble

complaisance - (n) 愿意顺从，讨好，彬彬有礼：comply, affability

compliant - 顺从的：submissive

compliment - (vt, n) 称赞，恭维：praise; 
(n) 敬意，免费赠送的礼物：respectful

clownish - 滑稽可笑的: funny way

compose - (vt) 使镇定：calm; 
(v) 组成，构成：form, constitute
