sermon - (n.) 布道，说教：public speech moral

serpentine - 弯曲的：winding

self-defeating - adj.适得其反的，自我拆台的

serried - 密集的：little space

servile - 低下的，卑屈的：submissive, abject

shifty - （显得）狡诈的，（显得）欺诈的：deceitful character

shackle - (vt) 束缚：restrictions；
{(vt) 限制，阻碍：create difficulty}

shadow - (vt) 偷偷尾随：secretly trail；
(v) 遮蔽，（使）变暗：gloomy

stale - adj.陈旧乏味的 so often as to be dull

sham - (v) 掩饰，假装：present a false appearance；
(adj) 虚假的：fake
{(n) 欺瞒：deceitfulness}

shiftless - 胸无大志的，懒惰的：lacking ambition

shipshape - 井然有序的：order

shirk - (v) 逃避，规避：keep away from

shoal - 浅的：little depth

shopworn - 陈旧的：worn-out

shred - 少量：small amount

shrewd - 精明的，机敏的：cleverness or judgment；
{刺骨的，强烈的：discomfort}

shrink - (vi)（在数量或价值方面）降低，减小：reduced
{(v) （使）本能性地退却（如因遇到使人惊恐的事物），（使）退缩：draw back；
(vi) 表示出不情愿，犹豫：hesitate}

shroud - (vt) 将...从视线中隔离，遮蔽：shut off from sight
{(n) 隐蔽物，可起隐蔽、保护或屏护作用的物体：conceals, protects, screens}

shrug - (vt) 轻视，忽略：dismiss；
{(v) 脱下（衣物等）：rid}

shun - (vt) 避开，避免：keep away

sidestep - (vt)（通过逃避而）不遵守：avoid having to comply with

signal - (adj)（在重要性、成就方面）非同寻常的：standing above；
(v) 给出信号：direct or notify

simpleton - （缺乏常识的）笨蛋：lacking in common sense

simulate - (vt) 假装，模仿：take on the appearance；
(vt) 模拟：create a representation

self-perpetuating - adj.自续的，能使自身永久存在的
 continuing without ant external intervention

sensuality - n.感官享乐 pursuit of fleshly pleasures

sinecure - 拿钱不干事的职务；闲差事；美差：requires little or no work

sinew - 活力，力量：vigorous strength

singe - (vt) 轻微烧焦：burn superficially

sinuous - 蜿蜒的，迂回的：irregular curves

snag - 障碍 hitch; difficulty

sacronsanct - 极为神圣的，不可侵犯的 most scared

scourge - 祸害：source of harm

skimp - (adj) 缺乏的，不足的：less plentiful；
(vi) 节省花费，吝啬：give insufficient funds

scruple - （良心上的）不安：uneasy feeling about the rightness

skirt - (n) 界限，边界：marks the outer limit；
(vt) 绕行，避开：go around

slack - 松弛的：not tightly fastened；
疏忽的，大意的：failing to give proper care

slake - (vt) 使满足：satisfy

slant - (n)（看待问题、思考的）角度，看法：way of looking；
(adj) 倾斜的：slanting direction；
{(vt) 歪曲（事实等）：create a wrong impression}

slate - (vt) 列入名单，计划，安排：put on a list

slew - 大量，许多：large amount

slight - 不重要的：deficient in weight；
(vt) 轻蔑，看不起：treat with disdain；
(vt) 忽略，疏忽：fail to give proper attention
{轻微的：small in degree}

sling - (vt) 投掷：send through the air

slippery - 光滑的：slide
意义不明确的：not precise in meaning
{隐秘的：acting in secret}

slipshod - 粗心的，随意的：indifference to exactness, precision, and accuracy

sloppy - 邋遢的，不整洁的：lacking neatness；
混乱的：lacking in order

sloth - (n) 怠惰，懒惰：disinclination to action

slouch - (vi) 缓慢行走：move slowly
{(n) 懒人：lazy person}

slovenly - 邋遢的，不整洁的：lacking neatness

sluggard - 懒人：lazy person

sluggish - 缓慢的，迟缓的：slow in movement；
{迟钝的，反应慢的：slow to respond}

slumber - (vi) 睡着：sleep

slur - (n) 耻辱：mark of guilt；
(vt) 疏忽，忽略：without due, consideration
{(vt) 含糊地发音：indistinctly}

sly - 狡猾的：clever or cunning
{隐秘的，偷偷的：acting in secret}

smarmy - 虚情假意的，过分恭维的：hypocritically

skullduggery - 欺诈，诡计 use of clever underhanded actions

smattering - 少量：small amount
{浅薄的知识：superficial knowledge}

smirk - (vi)（自鸣得意地）笑：offensively self-satisfied

smother - (vt) 使窒息：killed by lack of air；
(vt) 抑制（表达，说出），压制：refrain

smug - 自大的，自鸣得意的：opinion of oneself；
{整洁的，有序的：good order}

smuggling - (n) 走私，私运：importation or exportation contrary to the law

snare - (n) 无法逃脱的困境：catches and holds；
(vt) 捕捉：capture by

snarl - (v) 纠缠，纠结：twist
{(vi) 咆哮，怒吼：to anger}

sneer - (vt)（轻蔑地）嘲笑：scornful

snobbish - 谄上傲下的，自大的：offensive air of superiority

snub - (vt) 轻视，不理睬：contempt or neglect

soak - 使...湿透：make thoroughly wet

sober - 严肃的：serious-looking
{节制的：restraint；有理有据的：sound reasoning}

sodden - 湿透的：penetrated by water；
使...湿透：wet thoroughly

solace - (n) 安慰：comfort in sorrow；
(vt) 安慰，安抚：console

solder - (v) 连接，联合：unite

solemnity - 庄严，严肃：solemn

solicitous - 为他人操心的，体谅他人的：happiness of others
{迫切的，渴望的：urgent desire}

solid - 有理有据的：sound reasoning；
坚定的，不迟疑的：not showing weakness
{固态的，坚固的：not easily yield to pressure}

soliloquy - （尤指自言自语的）独白：without addressing a listener

solitude - (n) 孤独，避世：being alone

solvent - 有偿付能力的：able to pay debts；
(n) 溶剂：another substance is dissolved

somatic - 肉体的：of the body

somber - 悲伤的，不愉快的：lacking in cheer
{昏暗的，无光的：shaded}

somnolence - (n) 瞌睡，嗜睡：needing sleep

slapdash - adj.马虎的 careless

soothe - (vt) 带来慰藉，安慰：bring comfort
{(vt) 使镇静，使安心：free from distress;(vt) 弱化，缓解：less severe}

sop - (n) 安慰物：placate or soothe
(vt) 浸湿，湿透：wet thoroughly
{(n) 贿赂，回扣：improperly influence a person's conduct}

sophism - (n) 假推理，诡辩：deceptive argumentation

sophisticated - 精明的，老于世故的：worldly knowledge or refinement；
复杂的：complex

soporific - (n)催眠的药剂，安眠药：induces sleep；
(adj)催眠的：cause sleep；
{慵懒的，困倦的：sleepiness or lethargy}

sordid - 肮脏的，不干净的：not clean；
卑鄙的：baseness

sound - 牢固的，不可动摇的：withstand stress without structural damage；
健康的，强壮的：free from injury；
（逻辑）上严谨的：valid reasoning

sparse - 稀疏的，稀少的：less plentiful

spartan - 简朴的，节约的：simplicity

spat - (n)（小的）争吵：quarrel

spate - 大量：large number
{突发的洪水：sudden flood}

sleek - adj.时髦的，优美的 attractive

specious - 似是而非的，欺骗性的：false look of truth

speck - 小点，少量：small amount

spectator - 观众，目击者，旁观者：watches

spectrum - 光谱，范围，系列：sequence or range

speculate - (v) 推测，揣测：take to be true；
{(vt) 投机倒买：from market fluctuations}

spendthrift - n)挥霍家，败家子：spends improvidently；
adj)挥霍的，不节俭的：spending money freely
