secular - adj.世俗的，尘世的

simile - n.明喻

skittish - adj.容易受到惊吓的，胆小的；adj.善变的，多变的

sparing - adj.节俭的，节约的

splutter - v.急切而不清楚地说

squeamish - adj.恶心的，晕船的

staunch - adj.忠诚的，坚定的

stereotype - n.成见，老套的理念

stigmatize - v.使蒙上污名

substitute - n.取代者，替代品；v.取代，替代

succumb - v.屈服；v.死亡

supersede - v.取代，替代

surly - adj.脾气不好的

surmise - n.(根据不足的)推测，揣测；v.推测

surmount - v.战胜，获得胜利

surpass - v.超越，强于

surrogate - n.替代品

surveillance - n.监视，监控

tame - adj.被驯化的；v.控制，抑制

tangle - v.纠缠，使...纠结

teeming - adj.大量的

temporal - adj.世俗的，尘世的

tentative - adj.暂时性的，尝试的

thick-skinned - adj.冷漠无情的，不顾及他人感受的

thrill - n.强烈的兴奋感，快感；v.使兴奋，使激动

timely - adj.恰到好处的，合乎时宜的

trifling - adj.细微的，不重要的

tycoon - n.大亨，巨头

tyrant - n.暴君

umbrage - n.不悦，生气

unanimous - adj.一致同意的

unavailing - adj.徒劳的，无果的

unremitting - adj.连续不断的

vouchsafe - v.允诺，给予

wayward - adj.刚愎自用的，不服管束的

weather - v.经受住

willful - adj.固执的，倔强的

willy-nilly - adj.无秩序的，随意的

wilt - v.精神萎靡，憔悴

wily - adj.狡诈的，狡猾的

wiretap - n./vt.偷听，窃听

wistful - adj.渴望的，怀念的

wrest - v.辛苦地获得

wrongheaded - adj.固执己见的，坚持(错误观点的)
