mitigate - abate, curtail, temper, ameliorate 减弱

anomaly - aberration 异常

quiescent - abeyant, calm 不活跃的，静止的

unprecedented - abnormal 前所未有的

proliferate - abound 激增

synoptic - abridged 概要的

exonerate - absolve 免罪

general - abstract "笼统的，抽象的，深奥的
摘要，提取，分散注意力"

regular - abundant 常出现的

misuse - abuse 误用，虐待

acquiescence - accession 就职，遵守

hail - acclaim 称赞

consensus - accord 一致意见

mordant - acerbic 尖刻的

vitriolic - acerbic, opprobrium 尖酸刻薄的

realize - achieve 意识到，实现

concede - acknowledge 承认，感激

accession - acquiescence 默许

flexibility - adaptability, suppleness 灵活性，适应性

proficient - adept 精通的

disciple - adherent 信徒

nimble - adroit，dexterous, skillful 敏捷的，敏锐的

approbation - adulation, commendation 赞同

antagonistic - adversarial, inimical 敌对的

easygoing - affable 悠闲的

kindred - affiliated 同类的，相似的

opulent - affluent 富裕的，豪华的，奢侈的

exacerbate - aggravate 加剧

unsettle - alarm 危言耸听的

beneficence - altruism 慈善，善行

benevolent - altruistic, magnanimous 仁慈的

wondrous - amazing 奇妙的

equivocal - ambiguous 模棱两可的

comparable - analogous 类似的

galvanize - animate, rouse 激励

aberration - anomaly 异常

obscure - anonymous, opaque, obfuscate "不出名的，费解的
使..费解，遮盖"

adversarial - antagonistic 对立的

inimical - antagonistic, deleterious 有害的，不友好的

predate - antedate, precede 早于

archaic - antediluvian, outdated 古老的

foresee - anticipate 预见

prefigure - anticipate 预示

indifferent - apathy 冷漠的，公正的

extol - applaud 赞扬

fitting - apposite 合适的

commendation - approbation 赞同

adulation - approbation, sycophant 谄媚

pilfer - appropriate 偷窃

antediluvian - archaic 过时的

laborious - arduous 勤劳的

taxing - arduous 费劲的

hubris - arrogance 傲慢自大

specious - artificial, forged, fabricated, spurious 虚假的

spurious - artificial, implausible 虚假的

simplicity - artlessness 简单，简朴

slur - aspersion 贬低，使....模糊

maintain - assert 保持，断言

expansion - augmentation, burgeoning 扩张，增加

favorable - auspicious 赞同的，有利的

propitious - auspicious 吉利的

abstemious - austere, moderate 有节制的

rapacious - avaricious 贪婪的

ungainly - awkward "笨拙的，不合适的
尴尬的，棘手的"

stale - banal 陈腐的，平凡的

raillery - banter 开玩笑

untenable - baseless 站不住脚的

indebted - beholden 欠...人情的

mask - belie "证明...是错误的，掩饰，与...
不符"

boon - benefit 好处，恩惠

altruistic - benevolent 无私的

signify - betoken 表示

orientation - bias 目标，态度

unimpeachable - blameless 毋庸置疑的

insipid - bland 乏味的，无动于衷的

brandish - boast 吹嘘，自夸

buttress - bolster 支持

appropriate - borrow 挪用，合适的

boast - brandish 吹嘘，自夸

economy - brevity 节约

tolerate - brook 容许，容忍

pastoral - bucolic 乡村的

nascent - budding, unformed 刚出现的

onerous - burdensome 繁重的

no-nonsense - businesslike 高效率的

bolster - buttress, prop up 支持

circumvent - bypass, sidestep, skirt 避开

deliberate - calculated "深思熟虑，故意的
谨慎的"

heartless - callous 残酷的

solidarity - camaraderie 团结

mimic - camouflage, replicate 模仿，和...相似

formulaic - canned 无新意的

deft - canny 精明的

shrewd - canny, artful 精明的

arbitrary - capricious 随意的，武断的

whimsical - capricious 难以预测的

impulsive - capricious, hasty 冲动的

secure - capture, earn 获得，安全的，牢固的

vigilant - careful 警惕的

chastise - castigate 严厉批评

shriek - caterwaul 发出让人不爽的噪音

relinquish - cede 放弃

dispatch - celerity 速度，迅速

defend - champion 支持

espouse - champion, advocate, defend 拥护

allure - charm 引诱，魅力

castigate - chastise 严厉批评

stem - check 阻止

prudent - circumspect, provident 审慎的

contingent - circumstantial 依情况而定的

sidestep - circumvent 回避

bypass - circumvent, skirt 避开

comity - civility 礼貌

covert - clandestine 秘密的

archetypical - classic 典型的

orderly - coherent 连贯的，条理清楚的

immense - colossal 巨大的

meld - combine 混合

civility - comity 礼貌

equivalent - commensurate 相同的，等价的

analogous - comparable 类似的

offset - compensate 补偿，抵消

tractable - compliant 驯服的，温顺的

knotty - complicated 复杂难懂的

acknowledge - concede 承认

plausible - conceivable 可想象的

decry - condemn 谴责

meet - condign 适当的

circumscribe - confine, limit 限制

hew to - conform to 遵守

square with - conform to 遵从，与...一致

flummox - confound 使困惑

perplex - confound 迷惑

muddle - confuse 迷惑的

speculation - conjecture 推测

obtrusive - conspicuous 惹眼的

prominent - conspicuous, salient 显著的

deter - constrain 限制，强迫

ponder - contemplate 深入思考

discordance - contention 不一致

controversial - contentious 引起争议的，好争议的

circumstantial - contingent 取决于

dwindle - contract 逐渐减少，逐渐变小

dichotomous - contradictory 矛盾的

violate - contravene 触犯

contentious - controversial 引起争议的，好争议的

riddle - conundrum, enigma, puzzle 谜

intricate - convoluted 错综复杂的

tortuous - convoluted 弯曲的，冗长复杂的

upheaval - convulsion 剧变

deleterious - counterproductive, detrimental, devastating 有害的，有毒的

clandestine - covert, surreptitious 秘密的

enviable - coveted 令人羡慕的

cunning - crafty 狡猾的

disgruntle - crestfallen 使不高兴

disintegrate - crumble 瓦解

unwieldy - cumbersome 笨重的，难操作的

perfunctory - cursory, casual 敷衍的

palliate - damp 使减弱

perilous - dangerous, precarious 危险的

dim - darken 使变暗，使忧郁

formidable - daunting "可怕的，令人敬畏的
难对付的"

modicum - dearth 少量

curtail - v.削减，缩短

obfuscate - v. 使困惑，使模糊：confused, opaque
