confused - muddled 迷惑的

budding - nascent 萌芽期的

endemic - native, domestic, indigenous 地方性的

vague - nebulous 模糊的，不确定的

forsake - neglect 抛弃

dexterous - nimble 机敏的

adroit - nimble, dexterous, deft, acumen 精明的，灵巧的

businesslike - no-nonsense 高效率的

malodorous - noisome 难闻的

maverick - nonconformist 特立独行的人

unexceptional - nondescript 普通的

layperson - nonspecialist 门外汉

original - novel 原创的，新颖的

unexampled - novel 前所未有的

tyro - novice, neophyte 新手

occult - numinous 神秘的

intransigent - obdurate, resolute 不妥协的

fairness - objectivity 公平

anonymous - obscure "无名的，匿名的
无个性的"

opaque - obscure, inaccessible 不透明的，难懂的

obfuscate - obscure, mystify 混淆，使迷惑

sycophantic - obsequious, adulating 谄媚的

fixated - obsessed 过分迷恋的

fusty - obsolete, outmoded 霉臭的，守旧的

glean - obtain 搜集，获取

conspicuous - obtrusive, prominent, salient, remarkable 显眼的

displace - obviate 取代，迫使离开

sporadic - occasional, fitful 零星的

numinous - occult "神圣的，超自然的
神秘的"

universal - omnipresent, ubiquitous "广泛的，普遍适用的
无处不在的"

ubiquitous - omnipresent, universal 无处不在的

burdensome - onerous 繁重的

erstwhile - onetime 过去的

inaccessible - opaque 难以到达的，难以理解的

timely - opportune 适时的

disdain - opprobrium, contempt 鄙视

sanguine - optimistic 乐观的

stability - order 稳定

coherent - orderly 连贯的，条理清楚的

provenance - origin 起源

novel - original, unexampled, unprecedented 新颖的

generate - originate 产生

expel - oust 开除，驱逐

eclipse - outdo 衰退，使...不重要，胜过

overshadow - outlast, obscure 超越

obsolete - outmoded, fusty 废弃的，老式的

belabor - overemphasize 过分强调，抨击

dovish - pacific 和平主义的

damp - palliate 使减弱

cure-all - panacea 万灵药

remedy - panacea "治疗药物，改进措施
纠正，弥补"

ironic - paradoxical 讽刺的

counterpart - parallel 对应的人或物

stingy - parsimonious 吝啬的，微小的

apathy - passivity 冷漠

bucolic - pastoral 乡村的

hodgepodge - patchwork, welter, pastiche 大杂烩

vacuous - paucity 空洞的

dearth - paucity, modicum 缺乏

economic - pecuniary 有利可图的

limpid - pellucid 清晰的

faultless - perfect 无可挑剔的

cursory - perfunctory, casual 草率的

precarious - perilous 危险的，不稳固的

itinerant - peripatetic 流动的，巡回的

marginal - peripheral 不重要的，边缘的

porous - permeable 多孔的，能渗透的

confound - perplex, flummox 使迷惑，证明...有误

enigmatic - perplexing 神秘难懂的

commonplace - pervasive 常见，陈词滥调

conciliatory - placatory 愿意和解的

elegiac - plaintive 哀悼的

malleable - plastic 可塑的，易变的

conceivable - plausible 可想象的

gratify - please 使满足，使高兴

futile - pointless 无用的

contemplate - ponder 深入思考

permeable - porous 可渗透的

presage - portend 预示

didactic - preachy 说教的

sanctimonious - preachy, didactic 假装（比别人）圣洁的

impetuous - precipitate 鲁莽的

rule out - preclude 排除

prejudice - preconception 偏见，先入之见

forerunner - precursor 先驱，预兆

precede - predate, antedate 比......先发生

portend - predict, presage 预言

proclivity - predilection 倾向，嗜好

anticipate - prefigure, foresee 预期，先于某人做某事

preconception - prejudice 先入之见

prophetic - prescient 有预见的

exacting - prescriptive, rigorous, demanding 严格的

safeguard - preserve 保卫

exigent - pressing 迫切的

exceptional - preternatural 不寻常的，杰出的

preclude - prevent, rule out 排除，防止

rudimentary - primitive, sketchy, embryonic, sketchy, elemental 基本的，未完全发布的

unblemished - pristine 崭新的，清白的

profess - proclaim 公开宣称，信奉

predilection - proclivity, preference 偏爱

voracious - prodigious, insatiable 贪吃的，贪得无厌的

proclaim - profess 宣布，表明

trenchant - profound, incisive 有力的，有效的

wealth - profusion 财富，大量

abound - proliferate 充满

verbose - prolix, long-winded 啰嗦的

prescient - prophetic 有预知能力的

commensurate - proportionate 相称的

versatile - protean, fickle, volatile, flighty, erratic, capricious 多才多艺的，多功能的

parochial - provincial 狭隘的

insular - provincial, private 狭隘的

inflammatory - provocative 煽动性的

circumspect - prudent, chary, cautious 谨慎的

belligerent - pugnacious 好战的

truculent - pugnacious, bellicose, combative, aggressive 好斗的

design - purposefulness 故意，设计

elude - puzzle 避开，不能被......理解

imbibe - quaff 饮酒，吸收，接受

abeyance - quiescence 中止

idealistic - quixotic 空想的

banter - raillery 打趣

luxuriant - rampant 茂盛的，丰富的

haphazard - random, helter-skelter 随意的

diatribe - rant 抨击

avaricious - rapacious 贪婪的

reconciliation - rapprochement 和解

intelligible - readable 可理解的

verisimilitude - realism 逼真

pragmatic - realistic 务实的

repudiate - recant 拒绝承认，与......断绝关系

gauge - reckon 估计，判断，衡量仪器

shrink - recoil 退缩，回避，缩小，减少

rapprochement - reconciliation 和解

esoteric - recondite, arcane, abstruse 深奥难懂的

rehash - recycle 老调重弹，炒冷饭

liberation - rejection 解放，解脱

kinfolk - relative 亲戚

germane - relevant, apposite 密切相关的

vestige - relic 残留部分

delight - relish 高兴，使高兴

loath - reluctant, unwilling, disinclined 不情愿的

panacea - remedy, cure-all 万能药

strip away - remove 除去

censure - reprehend 谴责

deplorable - reprehensible 可悲的，应受谴责的

recant - repudiate 宣布放弃

homogeneity - resemblance, uniform 同质

tenacity - resolve, endurance 顽强

ring true - resonate 听来真实

hallow - respect 极其崇敬

deferential - respectful 恭敬的

lull - respite 使平静，蒙蔽，间歇

relief - respite 解脱

skittish - restive, fractious 易受惊的

fractious - restive, skittish 易怒的，难对付的

tonic - restorative 恢复健康的

rehabilitate - restore 恢复

recrudescent - resurgent 复发的

manifest - reveal, self-evident, obvious 明显的，清楚显示

emendation - revision 修订

renaissance - revival 复兴

eloquent - rhetoric 雄辩的

conundrum - riddle, puzzle, enigma 复杂难解的问题

pervasive - rife 普遍的，弥漫的

resonate - ring true 对某人有重要性，共振，一致
