paucity - dearth 不足

deterioration - decay, decline 恶化

unmistakable - decisive 毋庸置疑的，明显的

senescence - decrepitude 衰老，老朽

condemn - decry 公开谴责

calumny - defamation 诽谤

blemish - deflect 玷污，污点，缺点

champion - defend, espouse, support 支持

proponent - defender, champion 支持者

scarce - deficient 缺乏的

authoritative - definitive, cogent 有权威的

soothe - deflate 使减少

disregard - defy, contempt 忽视，贬低

counterproductive - deleterious 事与愿违的

detrimental - deleterious 有害的

relish - delight in 享受

lambaste - denounce 谴责

witless - dense 愚蠢的

reprehensible - deplorable 可悲的，应受谴责的

detract - deprecate 贬低，减损

mockery - derision 嘲笑

ridicule - derision 嘲弄，嘲笑

abandon - desert, relinquish 放弃，放纵

annihilate - destroy 消灭，毁灭

discern - detect, discover 觉察，分辨

constrain - deter 限制，强迫

decay - deterioration 腐朽

govern - determine 治理，决定

deprecatory - detracting 反对的

guile - deviousness 奸诈

rant - diatribe 咆哮，严厉批评

contradictory - dichotomous 矛盾的

timid - diffident 胆怯的，羞怯的

remiss - dilatory 懈怠的

sluggish - dilatory, listless 缓慢的

industrious - diligent 勤奋的

darken - dim 使变暗，使忧郁

minuscule - diminutive 极小的

detect - discern 发现

perceptible - discernible 可见的，可察觉的

perspicacious - discernible 有洞察力的

incongruity - discrepancy 矛盾

opprobrium - disdain, vitriol 谴责，耻辱

contemptuous - disdainful 轻蔑的

dump - disgorge 排出

crestfallen - disgruntled 不高兴的

crumble - disintegrate 崩溃，破碎

slight - disparage 贬低

heterogeneous - disparate, dissimilar 各种各样的

analytical - dispassionate 善于分析的，冷静客观的

temperate - dispassionate 温和的，适度的

celerity - dispatch 速度，迅速

defy - disregard, flout 蔑视

duplicity - dissemblance 欺骗

untether - divorce 脱离

dogmatic - doctrinaire, rigid 武断的，教条主义的

doctrinaire - dogmatic 教条主义的

extinguish - douse 熄灭，毁灭

pacific - dovish 和平主义的

spectacular - dramatic 壮观的

elicit - draw out 引出

tedious - dreary, boring 单调乏味的

humdrum - dull 单调的，乏味的

disgorge - dump 排出

dissemble - duplicity 伪装

contract - dwindle 逐渐减少，逐渐变小

keen - eager 渴望的

affable - easygoing, cordial, genteel 和蔼可亲的

wane - ebb, decline 衰落，减少，衰落期

outdo - eclipse 超过

pecuniary - economic 金钱的

euphoria - ecstasy 狂喜

flagrant - egregious 明目张胆的

chic - elegant 时髦的

plaintive - elegiac 悲伤的

draw - elicit 吸引

extirpate - eliminate 根除

put to rest - eliminated 排出

slippery - elusive "难以抓住的，棘手的
不可靠的"

cryptic - elusive 难解的

evasive - elusive, equivocal 逃避的，闪烁其词的

totemic - emblematic 象征的

revision - emendation 修订

effusive - emotional 溢于言表的，感情丰富的

imitate - emulate 模仿

captivate - enamor 迷住

tribute - encomium 称赞，贡品

polymath - encyclopedic 博学者

exhaustive - encyclopedic, comprehensive 全面的

sanction - endorse （经济）制裁，批准

induce - engender 引起

hone - enhance 磨砺，提升

inferable from - entailed by 能从...推断的

diverting - entertaining 有趣的

supplicate - entreat, solicit 恳求

covet - envy 贪求

short-lived - ephemeral 短暂的

transitory - ephemeral, evanescent 短暂的

parity - equality 平等，相等

wayward - errant, unpredictable 任性的

"
" - 

onetime - erstwhile 过去的

shun - eschew 避免

recondite - esoteric, arcane, abstruse 晦涩难懂的

abstruse - esoteric, arcane, recondite 难理解的

arcane - esoteric, recondite, abstruse 难懂的

requisite - essential 必需的

indispensable - essential, crucial 不可或缺的

lionize - eulogize 崇拜，把...视为名人

ecstasy - euphoria 狂喜

momentary - evanescent 短暂的

impartial - evenhanded, disinterested, fair, detachment 公正的

aggravate - exacerbate 加剧

demanding - exacting 苛求的

prescriptive - exacting 指定的，规定的

hyperbole - exaggeration 夸大

valorize - exalt 称赞

irascible - exasperation 易怒的

preternatural - exceptional 异乎寻常的

crab - excoriate 抱怨

indict - excoriate 控告

wield - exert 行使，施加

encyclopedic - exhaustive, polymathic 广博的，全面的

comprehensive - exhaustive, sweeping, generic, inclusive 全面的

pressing - exigent, critical 紧迫的，重要的

tenuous - exiguous 纤细的，脆弱的

absolve - exonerate 免罪

burgeon - expand, flourish 迅速生长

oust - expel, banish 罢黜，驱逐，取代

banish - expel, oust 驱逐

innovative - experimental 创新的

augment - extend, expand, enhance 增加

douse - extinguish 熄灭

eliminate - extirpate, put to rest 消除，淘汰

"
" - 

profligate - extravagant, prodigal 挥霍的

zealot - extremist, ideologue 狂热者

forge - fabricate 锻造，伪造

schism - factiousness 分裂

objective - fair 客观的，公正的

disinterested - fair, impartial 公正的，没有兴趣的

eminent - famous 杰出的

shortcoming - fault 缺点

enamor - favor, captivate, hooked on 使迷恋

auspicious - favorable 有望成功的

debacle - fiasco 彻底失败

volatile - fickle, versatile, flighty, erratic, capricious 善变的

erratic - fickle, versatile, volatile, flighty, capricious 难以预测的

impassioned - fiery 热情的

apposite - fitting, germane 合适的

obsessed - fixated 着迷的

egregious - flagrant 臭名昭著的

wanting - flawed 有缺陷的

supple - flexible "能适应的，灵活的
柔韧的"

spurn - flout 拒绝

precursor - forerunner 先驱

avert - forestall 转移，防止

stave off - forestall 延缓

daunting - formidable, sensational, forbidding 使人畏惧的

canned - formulaic 无新意的

adopt - foster 收养，采用

spur - foster 激励

bedrock - foundation 基础

inception - foundation 开始

restive - fractious 躁动不安的

malfeasance - fraudulence 渎职

genial - friendly 友善的

utilitarian - functional 实用的
